0	0.3481194021207278	0.18859123374861053	0.3333333333333333	0.1111111111111111	0.1111111111111111	0.	0.	0.1111111111111111
1	0.7764341575646507	0.4308555563599358	0.6666666666666666	0.3333333333333333	0.1111111111111111	0.	0.	0.1111111111111111
2	0.1362301500097826	0.8748445800449134	0.1111111111111111	0.7777777777777778	0.1111111111111111	0.	0.	0.1111111111111111
3	0.29717050492219405	0.5420619756294477	0.2222222222222222	0.4444444444444444	0.1111111111111111	0.	0.	0.1111111111111111
4	0.5507561225894105	0.8912517849135576	0.4444444444444444	0.8888888888888888	0.1111111111111111	0.	0.	0.1111111111111111
5	0.8247302222572953	0.24448559301673903	0.7777777777777778	0.2222222222222222	0.1111111111111111	0.	0.	0.1111111111111111
6	0.9427229294869155	0.6702753443343744	0.8888888888888888	0.6666666666666666	0.1111111111111111	0.	0.	0.1111111111111111
7	0.03646810739532157	0.06618502994731047	0.	0.	0.1111111111111111	0.	0.	0.1111111111111111
8	0.6160632020677668	0.5824199538742861	0.5555555555555556	0.5555555555555556	0.1111111111111111	0.	0.	0.1111111111111111
9	0.23945054267208193	0.7121341922626091	0.2222222222222222	0.6666666666666666	0.1111111111111111	0.	0.	0.1111111111111111
10	0.46455992677248414	0.1016061698275333	0.4444444444444444	0.	0.1111111111111111	0.	0.	0.1111111111111111
11	0.8618351975356333	0.6056381038054323	0.7777777777777778	0.5555555555555556	0.1111111111111111	0.	0.	0.1111111111111111
12	0.9893766451434804	0.14495656939816623	0.8888888888888888	0.1111111111111111	0.1111111111111111	0.	0.	0.1111111111111111
13	0.06684162660965168	0.3383719852772165	0.	0.3333333333333333	0.1111111111111111	0.	0.	0.1111111111111111
14	0.6306517309671766	0.8146572659282699	0.5555555555555556	0.7777777777777778	0.1111111111111111	0.	0.	0.1111111111111111
15	0.38985324719536624	0.45554007427142906	0.3333333333333333	0.4444444444444444	0.1111111111111111	0.	0.	0.1111111111111111
16	0.6815271636291802	0.9384252777606711	0.6666666666666666	0.8888888888888888	0.1111111111111111	0.	0.	0.1111111111111111
17	0.15502026619282222	0.2754278112878365	0.1111111111111111	0.2222222222222222	0.1111111111111111	0.	0.	0.1111111111111111
18	0.9014440104465754	0.4866556769364186	0.8888888888888888	0.4444444444444444	0.1111111111111111	0.	0.	0.1111111111111111
19	0.08808982221897925	0.9959271075103104	0.	0.8888888888888888	0.1111111111111111	0.	0.	0.1111111111111111
20	0.5652211087197645	0.2989883824480263	0.5555555555555556	0.2222222222222222	0.1111111111111111	0.	0.	0.1111111111111111
21	0.4178127467767113	0.7501792167734319	0.3333333333333333	0.6666666666666666	0.1111111111111111	0.	0.	0.1111111111111111
22	0.7131693792959584	0.028961659622842854	0.6666666666666666	0.	0.1111111111111111	0.	0.	0.1111111111111111
23	0.1951936259106833	0.6535633457424087	0.1111111111111111	0.5555555555555556	0.1111111111111111	0.	0.	0.1111111111111111
24	0.29110213201277885	0.1612428728999582	0.2222222222222222	0.1111111111111111	0.1111111111111111	0.	0.	0.1111111111111111
25	0.4955739214917981	0.39861168605704117	0.4444444444444444	0.3333333333333333	0.1111111111111111	0.	0.	0.1111111111111111
26	0.8133864271007447	0.8301501257633969	0.7777777777777778	0.7777777777777778	0.1111111111111111	0.	0.	0.1111111111111111
27	0.7785628541361597	0.355745054567829	0.7777777777777778	0.3333333333333333	0.1111111111111111	0.	0.	0.1111111111111111
28	0.26388296240401826	0.7789736481042608	0.2222222222222222	0.7777777777777778	0.1111111111111111	0.	0.	0.1111111111111111
29	0.5157503608437188	0.11761569739797631	0.4444444444444444	0.1111111111111111	0.1111111111111111	0.	0.	0.1111111111111111
30	0.5690246100191843	0.9567164476941229	0.5555555555555556	0.8888888888888888	0.1111111111111111	0.	0.	0.1111111111111111
31	0.9223101267969681	0.2946798613947338	0.8888888888888888	0.2222222222222222	0.1111111111111111	0.	0.	0.1111111111111111
32	0.10491815177763271	0.45840492361431784	0.	0.4444444444444444	0.1111111111111111	0.	0.	0.1111111111111111
33	0.19856885954905362	0.08391536308241046	0.1111111111111111	0.	0.1111111111111111	0.	0.	0.1111111111111111
34	0.4260857208647355	0.6217039379831734	0.3333333333333333	0.5555555555555556	0.1111111111111111	0.	0.	0.1111111111111111
35	0.7228356052863963	0.7255157750145047	0.6666666666666666	0.6666666666666666	0.1111111111111111	0.	0.	0.1111111111111111
36	0.6269520582841451	0.004957665864009927	0.5555555555555556	0.	0.1111111111111111	0.	0.	0.1111111111111111
37	0.9586851165908953	0.6561985350582048	0.8888888888888888	0.5555555555555556	0.1111111111111111	0.	0.	0.1111111111111111
38	0.0026372034925253186	0.7616781319310486	0.	0.6666666666666666	0.1111111111111111	0.	0.	0.1111111111111111
39	0.12271638185523702	0.37196129896303276	0.1111111111111111	0.3333333333333333	0.1111111111111111	0.	0.	0.1111111111111111
40	0.36533879686815773	0.8475002965920404	0.3333333333333333	0.7777777777777778	0.1111111111111111	0.	0.	0.1111111111111111
41	0.7424607409788627	0.17629208557423512	0.6666666666666666	0.1111111111111111	0.1111111111111111	0.	0.	0.1111111111111111
42	0.8304946996922165	0.9640620228873166	0.7777777777777778	0.8888888888888888	0.1111111111111111	0.	0.	0.1111111111111111
43	0.3162740884362468	0.3171721273282133	0.2222222222222222	0.2222222222222222	0.1111111111111111	0.	0.	0.1111111111111111
44	0.5231788924135433	0.5040873681481175	0.4444444444444444	0.4444444444444444	0.1111111111111111	0.	0.	0.1111111111111111
45	0.16534901092096524	0.9017023051664158	0.1111111111111111	0.8888888888888888	0.1111111111111111	0.	0.	0.1111111111111111
46	0.40184502563397817	0.25528798331916147	0.3333333333333333	0.2222222222222222	0.1111111111111111	0.	0.	0.1111111111111111
47	0.6951462635042345	0.5535230430210935	0.6666666666666666	0.4444444444444444	0.1111111111111111	0.	0.	0.1111111111111111
48	0.8721005950720382	0.04627319628759577	0.7777777777777778	0.	0.1111111111111111	0.	0.	0.1111111111111111
49	0.24729359628679834	0.5673385539503565	0.2222222222222222	0.5555555555555556	0.1111111111111111	0.	0.	0.1111111111111111
50	0.4737426075229251	0.6843664903157287	0.4444444444444444	0.6666666666666666	0.1111111111111111	0.	0.	0.1111111111111111
51	0.6442223013145801	0.44432605886262255	0.5555555555555556	0.3333333333333333	0.1111111111111111	0.	0.	0.1111111111111111
52	0.9641929280272699	0.8877500358531633	0.8888888888888888	0.7777777777777778	0.1111111111111111	0.	0.	0.1111111111111111
53	0.04193666776703009	0.20746754224107822	0.	0.1111111111111111	0.1111111111111111	0.	0.	0.1111111111111111
54	0.055567006937518995	0.817323289958128	0.	0.7777777777777778	0.1111111111111111	0.	0.	0.1111111111111111
55	0.6665249928654823	0.1571179181147197	0.5555555555555556	0.1111111111111111	0.1111111111111111	0.	0.	0.1111111111111111
56	0.9852491960830017	0.3916658023387778	0.8888888888888888	0.3333333333333333	0.1111111111111111	0.	0.	0.1111111111111111
57	0.6687874579601804	0.32548583149405924	0.6666666666666666	0.2222222222222222	0.1111111111111111	0.	0.	0.1111111111111111
58	0.1778241625212548	0.5108102968710052	0.1111111111111111	0.4444444444444444	0.1111111111111111	0.	0.	0.1111111111111111
59	0.37124381152696345	0.9810101361641375	0.3333333333333333	0.8888888888888888	0.1111111111111111	0.	0.	0.1111111111111111
60	0.45321276146204714	0.6398014759272751	0.4444444444444444	0.5555555555555556	0.1111111111111111	0.	0.	0.1111111111111111
61	0.8858547282459293	0.7721843350072967	0.7777777777777778	0.6666666666666666	0.1111111111111111	0.	0.	0.1111111111111111
62	0.23144851794351023	0.018408643500180673	0.2222222222222222	0.	0.1111111111111111	0.	0.	0.1111111111111111
63	0.730369875541955	0.5706166467962238	0.6666666666666666	0.5555555555555556	0.1111111111111111	0.	0.	0.1111111111111111
64	0.21931129890930132	0.6919272890254049	0.1111111111111111	0.6666666666666666	0.1111111111111111	0.	0.	0.1111111111111111
65	0.43334520441431795	0.05655418498013408	0.3333333333333333	0.	0.1111111111111111	0.	0.	0.1111111111111111
66	0.49063585104641527	0.8544070015185318	0.4444444444444444	0.7777777777777778	0.1111111111111111	0.	0.	0.1111111111111111
67	0.7992577430943945	0.2220595522848905	0.7777777777777778	0.1111111111111111	0.1111111111111111	0.	0.	0.1111111111111111
68	0.2778231707478607	0.4185731393605602	0.2222222222222222	0.3333333333333333	0.1111111111111111	0.	0.	0.1111111111111111
69	0.08452841962797343	0.23228305993560053	0.	0.2222222222222222	0.1111111111111111	0.	0.	0.1111111111111111
70	0.5890060218265845	0.5198873559489691	0.5555555555555556	0.4444444444444444	0.1111111111111111	0.	0.	0.1111111111111111
71	0.9003526338191852	0.9198755025060124	0.8888888888888888	0.8888888888888888	0.1111111111111111	0.	0.	0.1111111111111111
72	0.5362129457914826	0.2619744452045918	0.4444444444444444	0.2222222222222222	0.1111111111111111	0.	0.	0.1111111111111111
73	0.8505376458462596	0.47541089134292025	0.7777777777777778	0.4444444444444444	0.1111111111111111	0.	0.	0.1111111111111111
74	0.32266244442224123	0.9351550334069538	0.2222222222222222	0.8888888888888888	0.1111111111111111	0.	0.	0.1111111111111111
75	0.022489147013939514	0.6023761174902653	0.	0.5555555555555556	0.1111111111111111	0.	0.	0.1111111111111111
76	0.5994698454543189	0.7310242833680729	0.5555555555555556	0.6666666666666666	0.1111111111111111	0.	0.	0.1111111111111111
77	0.9296679539665064	0.08702348556824348	0.8888888888888888	0.	0.1111111111111111	0.	0.	0.1111111111111111
78	0.765086119817134	0.7982684278390518	0.6666666666666666	0.7777777777777778	0.1111111111111111	0.	0.	0.1111111111111111
79	0.12872747763563264	0.1291987992922078	0.1111111111111111	0.1111111111111111	0.1111111111111111	0.	0.	0.1111111111111111
80	0.33974758452522974	0.3627810806533432	0.3333333333333333	0.3333333333333333	0.1111111111111111	0.	0.	0.1111111111111111
81	0.782031928104866	0.3105450316026007	0.7777777777777778	0.2222222222222222	0.1111111111111111	0.	0.	0.1111111111111111
82	0.2699565837021766	0.4939177743556736	0.2222222222222222	0.4444444444444444	0.1111111111111111	0.	0.	0.1111111111111111
83	0.507352906159798	0.9671204938948561	0.4444444444444444	0.8888888888888888	0.1111111111111111	0.	0.	0.1111111111111111
84	0.5736796494863061	0.6586533295093745	0.5555555555555556	0.5555555555555556	0.1111111111111111	0.	0.	0.1111111111111111
85	0.9156890976925075	0.7562942762516964	0.8888888888888888	0.6666666666666666	0.1111111111111111	0.	0.	0.1111111111111111
86	0.10712017264184151	0.008674820843905686	0.	0.	0.1111111111111111	0.	0.	0.1111111111111111
87	0.2028120880652064	0.8482361705965427	0.1111111111111111	0.7777777777777778	0.1111111111111111	0.	0.	0.1111111111111111
88	0.4312232318031413	0.18084075999054014	0.3333333333333333	0.1111111111111111	0.1111111111111111	0.	0.	0.1111111111111111
89	0.7247581821449133	0.375744784972726	0.6666666666666666	0.3333333333333333	0.1111111111111111	0.	0.	0.1111111111111111
90	0.6175237426158258	0.8801886598207252	0.5555555555555556	0.7777777777777778	0.1111111111111111	0.	0.	0.1111111111111111
91	0.9612445329395061	0.20115084396925983	0.8888888888888888	0.1111111111111111	0.1111111111111111	0.	0.	0.1111111111111111
92	0.0048310704255671594	0.4359171265547945	0.	0.3333333333333333	0.1111111111111111	0.	0.	0.1111111111111111
93	0.11283652235198811	0.24980585027000643	0.1111111111111111	0.2222222222222222	0.1111111111111111	0.	0.	0.1111111111111111
94	0.3694103660755708	0.5434941413230213	0.3333333333333333	0.4444444444444444	0.1111111111111111	0.	0.	0.1111111111111111
95	0.7474234100200107	0.9081203395001652	0.6666666666666666	0.8888888888888888	0.1111111111111111	0.	0.	0.1111111111111111
96	0.8350735205093055	0.5561087684239644	0.7777777777777778	0.5555555555555556	0.1111111111111111	0.	0.	0.1111111111111111
97	0.3187148301114589	0.6884053758275376	0.2222222222222222	0.6666666666666666	0.1111111111111111	0.	0.	0.1111111111111111
98	0.5275130978767965	0.03838879999624043	0.4444444444444444	0.	0.1111111111111111	0.	0.	0.1111111111111111
99	0.17251195251059634	0.6276320765265463	0.1111111111111111	0.5555555555555556	0.1111111111111111	0.	0.	0.1111111111111111
100	0.40442598016544246	0.7162919563606251	0.3333333333333333	0.6666666666666666	0.1111111111111111	0.	0.	0.1111111111111111
101	0.6956418955253897	0.07590947175400078	0.6666666666666666	0.	0.1111111111111111	0.	0.	0.1111111111111111
102	0.8742125157281844	0.7851749867915048	0.7777777777777778	0.7777777777777778	0.1111111111111111	0.	0.	0.1111111111111111
103	0.2537393137201889	0.12115865749509531	0.2222222222222222	0.1111111111111111	0.1111111111111111	0.	0.	0.1111111111111111
104	0.47905835030148175	0.3478300309167869	0.4444444444444444	0.3333333333333333	0.1111111111111111	0.	0.	0.1111111111111111
105	0.6496712740111861	0.2859502120962942	0.5555555555555556	0.2222222222222222	0.1111111111111111	0.	0.	0.1111111111111111
106	0.9680113597020764	0.46275815577735235	0.8888888888888888	0.4444444444444444	0.1111111111111111	0.	0.	0.1111111111111111
107	0.047527041520683926	0.9599785742531204	0.	0.8888888888888888	0.1111111111111111	0.	0.	0.1111111111111111
108	0.05965367945903002	0.5235202932181524	0.	0.4444444444444444	0.1111111111111111	0.	0.	0.1111111111111111
109	0.6554709483455672	0.9223551717386498	0.5555555555555556	0.8888888888888888	0.1111111111111111	0.	0.	0.1111111111111111
110	0.9784260833625315	0.2234530812333986	0.8888888888888888	0.2222222222222222	0.1111111111111111	0.	0.	0.1111111111111111
111	0.6729805342501302	0.6964601769766837	0.6666666666666666	0.6666666666666666	0.1111111111111111	0.	0.	0.1111111111111111
112	0.18219167976597822	0.059301699279341244	0.1111111111111111	0.	0.1111111111111111	0.	0.	0.1111111111111111
113	0.374840972853142	0.5756990806269241	0.3333333333333333	0.5555555555555556	0.1111111111111111	0.	0.	0.1111111111111111
114	0.44839306197182915	0.21353897900497124	0.4444444444444444	0.1111111111111111	0.1111111111111111	0.	0.	0.1111111111111111
115	0.8800978360233291	0.4074997239842246	0.7777777777777778	0.3333333333333333	0.1111111111111111	0.	0.	0.1111111111111111
116	0.22468331129831734	0.8564388438079399	0.2222222222222222	0.7777777777777778	0.1111111111111111	0.	0.	0.1111111111111111
117	0.7352663684237929	0.13208334902149862	0.6666666666666666	0.1111111111111111	0.1111111111111111	0.	0.	0.1111111111111111
118	0.2130147372424246	0.3674542864286492	0.1111111111111111	0.3333333333333333	0.1111111111111111	0.	0.	0.1111111111111111
119	0.43707929534241374	0.8018927964683183	0.3333333333333333	0.7777777777777778	0.1111111111111111	0.	0.	0.1111111111111111
120	0.4818677035259571	0.48103196558954664	0.4444444444444444	0.4444444444444444	0.1111111111111111	0.	0.	0.1111111111111111
121	0.7941608391978119	0.9263918933655917	0.7777777777777778	0.8888888888888888	0.1111111111111111	0.	0.	0.1111111111111111
122	0.28287015730514625	0.2663353684081139	0.2222222222222222	0.2222222222222222	0.1111111111111111	0.	0.	0.1111111111111111
123	0.07660816479602003	0.7354319860627367	0.	0.6666666666666666	0.1111111111111111	0.	0.	0.1111111111111111
124	0.583620866095529	0.09456557850420416	0.5555555555555556	0.	0.1111111111111111	0.	0.	0.1111111111111111
125	0.8923024443690003	0.594934270500082	0.8888888888888888	0.5555555555555556	0.1111111111111111	0.	0.	0.1111111111111111
126	0.539632044774655	0.7753309238806589	0.4444444444444444	0.6666666666666666	0.1111111111111111	0.	0.	0.1111111111111111
127	0.8416163666897167	0.02363190364634191	0.7777777777777778	0.	0.1111111111111111	0.	0.	0.1111111111111111
128	0.3254286799822126	0.6305432089146256	0.2222222222222222	0.5555555555555556	0.1111111111111111	0.	0.	0.1111111111111111
129	0.013434822063149412	0.15201587595951851	0.	0.1111111111111111	0.1111111111111111	0.	0.	0.1111111111111111
130	0.6014149645726835	0.38479629558260153	0.5555555555555556	0.3333333333333333	0.1111111111111111	0.	0.	0.1111111111111111
131	0.9309565934357866	0.8212898870887201	0.8888888888888888	0.7777777777777778	0.1111111111111111	0.	0.	0.1111111111111111
132	0.7558460509471575	0.5175891914861185	0.6666666666666666	0.4444444444444444	0.1111111111111111	0.	0.	0.1111111111111111
133	0.13357000761688334	0.9855115079712095	0.1111111111111111	0.8888888888888888	0.1111111111111111	0.	0.	0.1111111111111111
134	0.34205687040986626	0.33291192557448873	0.3333333333333333	0.2222222222222222	0.1111111111111111	0.	0.	0.1111111111111111
135	0.3519647485654792	0.9441355419210503	0.3333333333333333	0.8888888888888888	0.1111111111111111	0.	0.	0.1111111111111111
136	0.7685523088928148	0.2788410957445946	0.6666666666666666	0.2222222222222222	0.1111111111111111	0.	0.	0.1111111111111111
137	0.14290979157102182	0.4456045835682859	0.1111111111111111	0.4444444444444444	0.1111111111111111	0.	0.	0.1111111111111111
138	0.30050930958033734	0.10414013407191451	0.2222222222222222	0.	0.1111111111111111	0.	0.	0.1111111111111111
139	0.5521730481666223	0.6094228872856542	0.4444444444444444	0.5555555555555556	0.1111111111111111	0.	0.	0.1111111111111111
140	0.8177140273377058	0.7050287463414634	0.7777777777777778	0.6666666666666666	0.1111111111111111	0.	0.	0.1111111111111111
141	0.9470216876767542	0.3456103255636883	0.8888888888888888	0.3333333333333333	0.1111111111111111	0.	0.	0.1111111111111111
142	0.026591944994765974	0.8052771545595773	0.	0.7777777777777778	0.1111111111111111	0.	0.	0.1111111111111111
143	0.6056437101170798	0.1381548339673211	0.5555555555555556	0.1111111111111111	0.1111111111111111	0.	0.	0.1111111111111111
144	0.24541460944777244	0.4010439425503213	0.2222222222222222	0.3333333333333333	0.1111111111111111	0.	0.	0.1111111111111111
145	0.46605038571755397	0.8325320166533579	0.4444444444444444	0.7777777777777778	0.1111111111111111	0.	0.	0.1111111111111111
146	0.8543799688749383	0.1678830001167027	0.7777777777777778	0.1111111111111111	0.1111111111111111	0.	0.	0.1111111111111111
147	0.9939825218347362	0.990749701934324	0.8888888888888888	0.8888888888888888	0.1111111111111111	0.	0.	0.1111111111111111
148	0.07034002014281698	0.3008201243240562	0.	0.2222222222222222	0.1111111111111111	0.	0.	0.1111111111111111
149	0.6358548923656264	0.4930264103817183	0.5555555555555556	0.4444444444444444	0.1111111111111111	0.	0.	0.1111111111111111
150	0.3935576787043222	0.0358756641116452	0.3333333333333333	0.	0.1111111111111111	0.	0.	0.1111111111111111
151	0.684018002465533	0.6444496408655351	0.6666666666666666	0.5555555555555556	0.1111111111111111	0.	0.	0.1111111111111111
152	0.1604717185380112	0.7410993149616307	0.1111111111111111	0.6666666666666666	0.1111111111111111	0.	0.	0.1111111111111111
153	0.9091804408929959	0.07125081864217049	0.8888888888888888	0.	0.1111111111111111	0.	0.	0.1111111111111111
154	0.09332038192745146	0.584402129198352	0.	0.5555555555555556	0.1111111111111111	0.	0.	0.1111111111111111
155	0.5587256357006973	0.6724374980935336	0.5555555555555556	0.6666666666666666	0.1111111111111111	0.	0.	0.1111111111111111
156	0.40792526850586885	0.4237848022883823	0.3333333333333333	0.3333333333333333	0.1111111111111111	0.	0.	0.1111111111111111
157	0.7077042398412404	0.8682841302524229	0.6666666666666666	0.7777777777777778	0.1111111111111111	0.	0.	0.1111111111111111
158	0.1891149196981853	0.19217513213831772	0.1111111111111111	0.1111111111111111	0.1111111111111111	0.	0.	0.1111111111111111
159	0.2926383233524166	0.8942398810507929	0.2222222222222222	0.8888888888888888	0.1111111111111111	0.	0.	0.1111111111111111
160	0.5014759712411596	0.23636383791427892	0.4444444444444444	0.2222222222222222	0.1111111111111111	0.	0.	0.1111111111111111
161	0.8029504466054884	0.5348720478573691	0.7777777777777778	0.4444444444444444	0.1111111111111111	0.	0.	0.1111111111111111
162	0.05151562079619388	0.0969396751066858	0.	0.	0.1111111111111111	0.	0.	0.1111111111111111
163	0.6599073304733418	0.5995138149065041	0.5555555555555556	0.5555555555555556	0.1111111111111111	0.	0.	0.1111111111111111
164	0.9819470742206065	0.7386742487609288	0.8888888888888888	0.6666666666666666	0.1111111111111111	0.	0.	0.1111111111111111
165	0.6778779176372712	0.3614578912990841	0.6666666666666666	0.3333333333333333	0.1111111111111111	0.	0.	0.1111111111111111
166	0.1748187234705941	0.7932815422160081	0.1111111111111111	0.7777777777777778	0.1111111111111111	0.	0.	0.1111111111111111
167	0.3813330550689245	0.12626841047979104	0.3333333333333333	0.1111111111111111	0.1111111111111111	0.	0.	0.1111111111111111
168	0.4500405854029745	0.9311111868771953	0.4444444444444444	0.8888888888888888	0.1111111111111111	0.	0.	0.1111111111111111
169	0.8839292888645685	0.2677192454836843	0.7777777777777778	0.2222222222222222	0.1111111111111111	0.	0.	0.1111111111111111
170	0.2272460530604513	0.47102337601630223	0.2222222222222222	0.4444444444444444	0.1111111111111111	0.	0.	0.1111111111111111
171	0.7397185869193064	0.9775544387035935	0.6666666666666666	0.8888888888888888	0.1111111111111111	0.	0.	0.1111111111111111
172	0.21552486863956233	0.324346780568266	0.1111111111111111	0.2222222222222222	0.1111111111111111	0.	0.	0.1111111111111111
173	0.44436376380358833	0.508017956169582	0.3333333333333333	0.4444444444444444	0.1111111111111111	0.	0.	0.1111111111111111
174	0.489300786567331	0.01564706265875026	0.4444444444444444	0.	0.1111111111111111	0.	0.	0.1111111111111111
175	0.795731617419267	0.6346724888884232	0.7777777777777778	0.5555555555555556	0.1111111111111111	0.	0.	0.1111111111111111
176	0.2738410676399032	0.766370842783864	0.2222222222222222	0.6666666666666666	0.1111111111111111	0.	0.	0.1111111111111111
177	0.08076448257576108	0.38947759248048797	0.	0.3333333333333333	0.1111111111111111	0.	0.	0.1111111111111111
178	0.5870390203687275	0.8247061829160685	0.5555555555555556	0.7777777777777778	0.1111111111111111	0.	0.	0.1111111111111111
179	0.8957624988525926	0.15296024607860462	0.8888888888888888	0.1111111111111111	0.1111111111111111	0.	0.	0.1111111111111111
180	0.5347772929307653	0.4121544339213648	0.4444444444444444	0.3333333333333333	0.1111111111111111	0.	0.	0.1111111111111111
181	0.845278636429233	0.8617434909764586	0.7777777777777778	0.7777777777777778	0.1111111111111111	0.	0.	0.1111111111111111
182	0.3301086320880325	0.21604426209545843	0.2222222222222222	0.1111111111111111	0.1111111111111111	0.	0.	0.1111111111111111
183	0.01824584708528412	0.9175901639007018	0.	0.8888888888888888	0.1111111111111111	0.	0.	0.1111111111111111
184	0.5954625139439472	0.22654971146866731	0.5555555555555556	0.2222222222222222	0.1111111111111111	0.	0.	0.1111111111111111
185	0.9356723584814501	0.5295267325592237	0.8888888888888888	0.4444444444444444	0.1111111111111111	0.	0.	0.1111111111111111
186	0.7576415273173641	0.049562914744724997	0.6666666666666666	0.	0.1111111111111111	0.	0.	0.1111111111111111
187	0.1263163394541067	0.5779041395338629	0.1111111111111111	0.5555555555555556	0.1111111111111111	0.	0.	0.1111111111111111
188	0.33614809670017226	0.70142586169038	0.3333333333333333	0.6666666666666666	0.1111111111111111	0.	0.	0.1111111111111111
189	0.3577980487242635	0.6469515099221645	0.3333333333333333	0.5555555555555556	0.1111111111111111	0.	0.	0.1111111111111111
190	0.7708617926675186	0.7454150435153332	0.6666666666666666	0.6666666666666666	0.1111111111111111	0.	0.	0.1111111111111111
191	0.1449414652236767	0.02636164999867452	0.1111111111111111	0.	0.1111111111111111	0.	0.	0.1111111111111111
192	0.30852911516165754	0.835659632171218	0.2222222222222222	0.7777777777777778	0.1111111111111111	0.	0.	0.1111111111111111
193	0.5460813853170615	0.1708018975389468	0.4444444444444444	0.1111111111111111	0.1111111111111111	0.	0.	0.1111111111111111
194	0.8201120127128847	0.4035772821504028	0.7777777777777778	0.3333333333333333	0.1111111111111111	0.	0.	0.1111111111111111
195	0.9417693910349694	0.3068232872939252	0.8888888888888888	0.2222222222222222	0.1111111111111111	0.	0.	0.1111111111111111
196	0.030252407911928143	0.4841381685417263	0.	0.4444444444444444	0.1111111111111111	0.	0.	0.1111111111111111
197	0.6114458701227855	0.995426265818034	0.5555555555555556	0.8888888888888888	0.1111111111111111	0.	0.	0.1111111111111111
198	0.23824183186140163	0.2413866879060871	0.2222222222222222	0.2222222222222222	0.1111111111111111	0.	0.	0.1111111111111111
199	0.460548547980039	0.5354098820863687	0.4444444444444444	0.4444444444444444	0.1111111111111111	0.	0.	0.1111111111111111
200	0.8572937418048293	0.9002461655213766	0.7777777777777778	0.8888888888888888	0.1111111111111111	0.	0.	0.1111111111111111
201	0.9991307739018419	0.5902727454011001	0.8888888888888888	0.5555555555555556	0.1111111111111111	0.	0.	0.1111111111111111
202	0.06569218215336395	0.6776653157339854	0.	0.6666666666666666	0.1111111111111111	0.	0.	0.1111111111111111
203	0.6381698912504686	0.06310395387133659	0.5555555555555556	0.	0.1111111111111111	0.	0.	0.1111111111111111
204	0.3846659918563747	0.8716005733329539	0.3333333333333333	0.7777777777777778	0.1111111111111111	0.	0.	0.1111111111111111
205	0.6892607100429666	0.19605321562295241	0.6666666666666666	0.1111111111111111	0.1111111111111111	0.	0.	0.1111111111111111
206	0.1500128739964499	0.4260460284191802	0.1111111111111111	0.3333333333333333	0.1111111111111111	0.	0.	0.1111111111111111
207	0.9114839707578468	0.8070736711432249	0.8888888888888888	0.7777777777777778	0.1111111111111111	0.	0.	0.1111111111111111
208	0.09741432561835073	0.1417997186342236	0.	0.1111111111111111	0.1111111111111111	0.	0.	0.1111111111111111
209	0.5601525160086891	0.33340493340127236	0.5555555555555556	0.3333333333333333	0.1111111111111111	0.	0.	0.1111111111111111
210	0.4129051582848354	0.2803953165901524	0.3333333333333333	0.2222222222222222	0.1111111111111111	0.	0.	0.1111111111111111
211	0.7098008231567744	0.45234630496444056	0.6666666666666666	0.4444444444444444	0.1111111111111111	0.	0.	0.1111111111111111
212	0.1907003426450169	0.948872867519749	0.1111111111111111	0.8888888888888888	0.1111111111111111	0.	0.	0.1111111111111111
213	0.2860684152750976	0.6149297798238028	0.2222222222222222	0.5555555555555556	0.1111111111111111	0.	0.	0.1111111111111111
214	0.5023319619353774	0.7086778150927033	0.4444444444444444	0.6666666666666666	0.1111111111111111	0.	0.	0.1111111111111111