0	0.5725073487272379	0.08464966343068138	0.5555555555555556	0.	0.1111111111111111	0.	0.	0.1111111111111111
1	0.26853864544405487	0.9506990082464809	0.2222222222222222	0.8888888888888888	0.1111111111111111	0.	0.	0.1111111111111111
2	0.7296555965061519	0.6039164739856251	0.6666666666666666	0.5555555555555556	0.1111111111111111	0.	0.	0.1111111111111111
3	0.05470963617517917	0.5412821330331516	0.	0.4444444444444444	0.1111111111111111	0.	0.	0.1111111111111111
4	0.8825277014883606	0.2473058018019968	0.7777777777777778	0.2222222222222222	0.1111111111111111	0.	0.	0.1111111111111111
5	0.3489089120770103	0.7967660068696059	0.3333333333333333	0.7777777777777778	0.1111111111111111	0.	0.	0.1111111111111111
6	0.902061513495913	0.7337287505548871	0.8888888888888888	0.6666666666666666	0.1111111111111111	0.	0.	0.1111111111111111
7	0.5339864579714231	0.4327782235595702	0.4444444444444444	0.3333333333333333	0.1111111111111111	0.	0.	0.1111111111111111
8	0.11274811109263082	0.18082121963697523	0.1111111111111111	0.1111111111111111	0.1111111111111111	0.	0.	0.1111111111111111
9	0.9550042219544737	0.015146043725804772	0.8888888888888888	0.	0.1111111111111111	0.	0.	0.1111111111111111
10	0.46603383264361464	0.999539797184036	0.4444444444444444	0.8888888888888888	0.1111111111111111	0.	0.	0.1111111111111111
11	0.1621241031816811	0.6301415901625171	0.1111111111111111	0.5555555555555556	0.1111111111111111	0.	0.	0.1111111111111111
12	0.6291162589149143	0.4641901244412502	0.5555555555555556	0.4444444444444444	0.1111111111111111	0.	0.	0.1111111111111111
13	0.32942607052806994	0.2645834794762236	0.2222222222222222	0.2222222222222222	0.1111111111111111	0.	0.	0.1111111111111111
14	0.7690417366301624	0.8424295537623636	0.6666666666666666	0.7777777777777778	0.1111111111111111	0.	0.	0.1111111111111111
15	0.0806039042504022	0.775949776024021	0.	0.6666666666666666	0.1111111111111111	0.	0.	0.1111111111111111
16	0.8111827164274389	0.3582888582505162	0.7777777777777778	0.3333333333333333	0.1111111111111111	0.	0.	0.1111111111111111
17	0.40515124984350886	0.19279241922936433	0.3333333333333333	0.1111111111111111	0.1111111111111111	0.	0.	0.1111111111111111
18	0.02356368577777172	0.053765276380792204	0.	0.	0.1111111111111111	0.	0.	0.1111111111111111
19	0.8497976419620905	0.9257387933347017	0.7777777777777778	0.8888888888888888	0.1111111111111111	0.	0.	0.1111111111111111
20	0.40983862282685485	0.5691533280436974	0.3333333333333333	0.5555555555555556	0.1111111111111111	0.	0.	0.1111111111111111
21	0.9774155207366949	0.5126491851596419	0.8888888888888888	0.4444444444444444	0.1111111111111111	0.	0.	0.1111111111111111
22	0.5047474167015468	0.3316674689345095	0.4444444444444444	0.2222222222222222	0.1111111111111111	0.	0.	0.1111111111111111
23	0.20099200019336103	0.8557195383644256	0.1111111111111111	0.7777777777777778	0.1111111111111111	0.	0.	0.1111111111111111
24	0.6517342315023166	0.6855104893535974	0.5555555555555556	0.6666666666666666	0.1111111111111111	0.	0.	0.1111111111111111
25	0.24133272586589163	0.37162838678192195	0.2222222222222222	0.3333333333333333	0.1111111111111111	0.	0.	0.1111111111111111
26	0.7014102567679807	0.11378835636818031	0.6666666666666666	0.1111111111111111	0.1111111111111111	0.	0.	0.1111111111111111
27	0.10916366205230141	0.4166482936494015	0.	0.3333333333333333	0.1111111111111111	0.	0.	0.1111111111111111
28	0.8010698646004412	0.14849859683079383	0.7777777777777778	0.1111111111111111	0.1111111111111111	0.	0.	0.1111111111111111
29	0.3928878758913549	0.7142157720694702	0.3333333333333333	0.6666666666666666	0.1111111111111111	0.	0.	0.1111111111111111
30	0.9492460649562255	0.9268124398724474	0.8888888888888888	0.8888888888888888	0.1111111111111111	0.	0.	0.1111111111111111
31	0.4558105960162577	0.6172604765533365	0.4444444444444444	0.5555555555555556	0.1111111111111111	0.	0.	0.1111111111111111
32	0.1484393321971845	0.08874580025976203	0.1111111111111111	0.	0.1111111111111111	0.	0.	0.1111111111111111
33	0.6068097257155304	0.22708693998198262	0.5555555555555556	0.2222222222222222	0.1111111111111111	0.	0.	0.1111111111111111
34	0.31919773177854144	0.8116586342959266	0.2222222222222222	0.7777777777777778	0.1111111111111111	0.	0.	0.1111111111111111
35	0.7590453517117246	0.5540655655239064	0.6666666666666666	0.4444444444444444	0.1111111111111111	0.	0.	0.1111111111111111
36	0.6314683406775973	0.3430750715923029	0.5555555555555556	0.3333333333333333	0.1111111111111111	0.	0.	0.1111111111111111
37	0.2339148450836493	0.20221275820718582	0.2222222222222222	0.1111111111111111	0.1111111111111111	0.	0.	0.1111111111111111
38	0.6874277816869241	0.745374276440673	0.6666666666666666	0.6666666666666666	0.1111111111111111	0.	0.	0.1111111111111111
39	0.00812719105657144	0.9689002233780499	0.	0.8888888888888888	0.1111111111111111	0.	0.	0.1111111111111111
40	0.835576803992935	0.6420481123977587	0.7777777777777778	0.5555555555555556	0.1111111111111111	0.	0.	0.1111111111111111
41	0.4324575891665521	0.03474988300545629	0.3333333333333333	0.	0.1111111111111111	0.	0.	0.1111111111111111
42	0.9713264691756318	0.2741221154155324	0.8888888888888888	0.2222222222222222	0.1111111111111111	0.	0.	0.1111111111111111
43	0.48707754156320143	0.8230209020600698	0.4444444444444444	0.7777777777777778	0.1111111111111111	0.	0.	0.1111111111111111
44	0.1971334691077735	0.4753465237267477	0.1111111111111111	0.4444444444444444	0.1111111111111111	0.	0.	0.1111111111111111
45	0.8933018898750087	0.3878355729743899	0.8888888888888888	0.3333333333333333	0.1111111111111111	0.	0.	0.1111111111111111
46	0.51921216536382	0.13044528387518162	0.4444444444444444	0.1111111111111111	0.1111111111111111	0.	0.	0.1111111111111111
47	0.141943626872386	0.6929575916156567	0.1111111111111111	0.6666666666666666	0.1111111111111111	0.	0.	0.1111111111111111
48	0.5636914279633432	0.9006319160712569	0.5555555555555556	0.8888888888888888	0.1111111111111111	0.	0.	0.1111111111111111
49	0.2960604922128077	0.5818408363356677	0.2222222222222222	0.5555555555555556	0.1111111111111111	0.	0.	0.1111111111111111
50	0.72252438787941	0.07353710970097918	0.6666666666666666	0.	0.1111111111111111	0.	0.	0.1111111111111111
51	0.03763480614470031	0.3065802034371324	0.	0.2222222222222222	0.1111111111111111	0.	0.	0.1111111111111111
52	0.8644331947038557	0.8658479520942426	0.7777777777777778	0.7777777777777778	0.1111111111111111	0.	0.	0.1111111111111111
53	0.3438205501482052	0.4919364473777225	0.3333333333333333	0.4444444444444444	0.1111111111111111	0.	0.	0.1111111111111111
54	0.9922596126126241	0.7886744859278727	0.8888888888888888	0.7777777777777778	0.1111111111111111	0.	0.	0.1111111111111111
55	0.5164845321332502	0.523595871736837	0.4444444444444444	0.4444444444444444	0.1111111111111111	0.	0.	0.1111111111111111
56	0.21864061419494693	0.2444208846854939	0.1111111111111111	0.2222222222222222	0.1111111111111111	0.	0.	0.1111111111111111
57	0.6544027076482266	0.16363690305496462	0.5555555555555556	0.1111111111111111	0.1111111111111111	0.	0.	0.1111111111111111
58	0.2518834731359119	0.7263593442352331	0.2222222222222222	0.6666666666666666	0.1111111111111111	0.	0.	0.1111111111111111
59	0.6742186790573519	0.4236283030795858	0.6666666666666666	0.3333333333333333	0.1111111111111111	0.	0.	0.1111111111111111
60	0.0313759889968029	0.6229071474499808	0.	0.5555555555555556	0.1111111111111111	0.	0.	0.1111111111111111
61	0.8166399729743428	0.09950003616527021	0.7777777777777778	0.	0.1111111111111111	0.	0.	0.1111111111111111
62	0.42460228013392454	0.9393488126368384	0.3333333333333333	0.8888888888888888	0.1111111111111111	0.	0.	0.1111111111111111
63	0.06939861923513294	0.8274206289246274	0.	0.7777777777777778	0.1111111111111111	0.	0.	0.1111111111111111
64	0.8538963685698788	0.4498366984061771	0.7777777777777778	0.4444444444444444	0.1111111111111111	0.	0.	0.1111111111111111
65	0.3639843185130734	0.29268859861461793	0.3333333333333333	0.2222222222222222	0.1111111111111111	0.	0.	0.1111111111111111
66	0.9233158178855808	0.2213557201238609	0.8888888888888888	0.1111111111111111	0.1111111111111111	0.	0.	0.1111111111111111
67	0.5454084111006667	0.7601138720363342	0.4444444444444444	0.6666666666666666	0.1111111111111111	0.	0.	0.1111111111111111
68	0.1268860477502176	0.3508674429795925	0.1111111111111111	0.3333333333333333	0.1111111111111111	0.	0.	0.1111111111111111
69	0.5858930303847026	0.6657103534518193	0.5555555555555556	0.5555555555555556	0.1111111111111111	0.	0.	0.1111111111111111
70	0.2837630209416553	0.0029968471801706904	0.2222222222222222	0.	0.1111111111111111	0.	0.	0.1111111111111111
71	0.7086119977166895	0.9784796504829838	0.6666666666666666	0.8888888888888888	0.1111111111111111	0.	0.	0.1111111111111111
72	0.6004142233169294	0.8866004124354233	0.5555555555555556	0.7777777777777778	0.1111111111111111	0.	0.	0.1111111111111111
73	0.30333322579298766	0.4957969857569063	0.2222222222222222	0.4444444444444444	0.1111111111111111	0.	0.	0.1111111111111111
74	0.746007436896297	0.3179515208000955	0.6666666666666666	0.2222222222222222	0.1111111111111111	0.	0.	0.1111111111111111
75	0.08981610675732746	0.14319358657702114	0.	0.1111111111111111	0.1111111111111111	0.	0.	0.1111111111111111
76	0.7866043734202195	0.6712603464466401	0.7777777777777778	0.6666666666666666	0.1111111111111111	0.	0.	0.1111111111111111
77	0.3704516885614001	0.40321592198152095	0.3333333333333333	0.3333333333333333	0.1111111111111111	0.	0.	0.1111111111111111
78	0.9327089874175448	0.5614914212758635	0.8888888888888888	0.5555555555555556	0.1111111111111111	0.	0.	0.1111111111111111
79	0.47572208982129155	0.044851049854171925	0.4444444444444444	0.	0.1111111111111111	0.	0.	0.1111111111111111
80	0.17520208127144252	0.9123771079988838	0.1111111111111111	0.8888888888888888	0.1111111111111111	0.	0.	0.1111111111111111
81	0.2606666276066089	0.2550104597075143	0.2222222222222222	0.2222222222222222	0.1111111111111111	0.	0.	0.1111111111111111
82	0.7341890239229621	0.8006775948634286	0.6666666666666666	0.7777777777777778	0.1111111111111111	0.	0.	0.1111111111111111
83	0.5770689608519904	0.533886555321893	0.5555555555555556	0.4444444444444444	0.1111111111111111	0.	0.	0.1111111111111111
84	0.888413473489094	0.4378181540453668	0.7777777777777778	0.3333333333333333	0.1111111111111111	0.	0.	0.1111111111111111
85	0.35273116044894237	0.18418564847766744	0.3333333333333333	0.1111111111111111	0.1111111111111111	0.	0.	0.1111111111111111
86	0.059207889062711225	0.7369505032381841	0.	0.6666666666666666	0.1111111111111111	0.	0.	0.1111111111111111
87	0.5355981185600125	0.9578069131668117	0.4444444444444444	0.8888888888888888	0.1111111111111111	0.	0.	0.1111111111111111
88	0.1173365175325046	0.5934001303340121	0.1111111111111111	0.5555555555555556	0.1111111111111111	0.	0.	0.1111111111111111
89	0.9074048146173292	0.07699037741565257	0.8888888888888888	0.	0.1111111111111111	0.	0.	0.1111111111111111
90	0.46072533780387304	0.2696643207220772	0.4444444444444444	0.2222222222222222	0.1111111111111111	0.	0.	0.1111111111111111
91	0.16714130040069552	0.843960296242016	0.1111111111111111	0.7777777777777778	0.1111111111111111	0.	0.	0.1111111111111111
92	0.9600440018717408	0.46902020369569736	0.8888888888888888	0.4444444444444444	0.1111111111111111	0.	0.	0.1111111111111111
93	0.32294019517726996	0.36588470157033953	0.2222222222222222	0.3333333333333333	0.1111111111111111	0.	0.	0.1111111111111111
94	0.770696751490945	0.19546439114633402	0.6666666666666666	0.1111111111111111	0.1111111111111111	0.	0.	0.1111111111111111
95	0.6179040219355392	0.7681494898944283	0.5555555555555556	0.6666666666666666	0.1111111111111111	0.	0.	0.1111111111111111
96	0.8045089281102358	0.9882770629614276	0.7777777777777778	0.8888888888888888	0.1111111111111111	0.	0.	0.1111111111111111
97	0.3970526883173355	0.636746964441866	0.3333333333333333	0.5555555555555556	0.1111111111111111	0.	0.	0.1111111111111111
98	0.08480385420882236	0.0185788891855261	0.	0.	0.1111111111111111	0.	0.	0.1111111111111111
99	0.8402048331866449	0.3234279227808213	0.7777777777777778	0.2222222222222222	0.1111111111111111	0.	0.	0.1111111111111111
100	0.4130150010384885	0.856361364684217	0.3333333333333333	0.7777777777777778	0.1111111111111111	0.	0.	0.1111111111111111
101	0.01487087758713419	0.5157855121424241	0.	0.4444444444444444	0.1111111111111111	0.	0.	0.1111111111111111
102	0.497187134226829	0.3746625947464195	0.4444444444444444	0.3333333333333333	0.1111111111111111	0.	0.	0.1111111111111111
103	0.2029762860580148	0.1165990182482751	0.1111111111111111	0.1111111111111111	0.1111111111111111	0.	0.	0.1111111111111111
104	0.9834168364458048	0.6890862363933123	0.8888888888888888	0.6666666666666666	0.1111111111111111	0.	0.	0.1111111111111111
105	0.24490751442936723	0.917092659667431	0.2222222222222222	0.8888888888888888	0.1111111111111111	0.	0.	0.1111111111111111
106	0.6952229553696457	0.5742166826907288	0.6666666666666666	0.5555555555555556	0.1111111111111111	0.	0.	0.1111111111111111
107	0.6457628883948883	0.058397543863510024	0.5555555555555556	0.	0.1111111111111111	0.	0.	0.1111111111111111
108	0.7908505221054534	0.60825598634425	0.7777777777777778	0.5555555555555556	0.1111111111111111	0.	0.	0.1111111111111111
109	0.38404908505841406	0.09172146115724233	0.3333333333333333	0.	0.1111111111111111	0.	0.	0.1111111111111111
110	0.09932924327086895	0.9325477913310191	0.	0.8888888888888888	0.1111111111111111	0.	0.	0.1111111111111111
111	0.4477316221651871	0.8051783523509001	0.4444444444444444	0.7777777777777778	0.1111111111111111	0.	0.	0.1111111111111111
112	0.1559139446201738	0.5458379125632667	0.1111111111111111	0.4444444444444444	0.1111111111111111	0.	0.	0.1111111111111111
113	0.9397104636180802	0.23293487626222753	0.8888888888888888	0.2222222222222222	0.1111111111111111	0.	0.	0.1111111111111111
114	0.30886350893709874	0.1539392607257451	0.2222222222222222	0.1111111111111111	0.1111111111111111	0.	0.	0.1111111111111111
115	0.7641296026894783	0.7068103643842132	0.6666666666666666	0.6666666666666666	0.1111111111111111	0.	0.	0.1111111111111111
116	0.6130947658785285	0.4109888708888944	0.5555555555555556	0.3333333333333333	0.1111111111111111	0.	0.	0.1111111111111111
117	0.2237565860901074	0.6468044621150639	0.2222222222222222	0.5555555555555556	0.1111111111111111	0.	0.	0.1111111111111111
118	0.6829395618258074	0.02471133115522963	0.6666666666666666	0.	0.1111111111111111	0.	0.	0.1111111111111111
119	0.6353618062432075	0.9713899437053265	0.5555555555555556	0.8888888888888888	0.1111111111111111	0.	0.	0.1111111111111111
120	0.8307463831630237	0.8258702746789076	0.7777777777777778	0.7777777777777778	0.1111111111111111	0.	0.	0.1111111111111111
121	0.4385335576129876	0.47866784952959307	0.3333333333333333	0.4444444444444444	0.1111111111111111	0.	0.	0.1111111111111111
122	0.010366960741717512	0.2792968666834414	0.	0.2222222222222222	0.1111111111111111	0.	0.	0.1111111111111111
123	0.4920606844827972	0.2091200335733061	0.4444444444444444	0.1111111111111111	0.1111111111111111	0.	0.	0.1111111111111111
124	0.18883080032455382	0.7505923535878525	0.1111111111111111	0.6666666666666666	0.1111111111111111	0.	0.	0.1111111111111111
125	0.966507948421902	0.33403566066945933	0.8888888888888888	0.3333333333333333	0.1111111111111111	0.	0.	0.1111111111111111
126	0.5265269600476226	0.5848412868358477	0.4444444444444444	0.5555555555555556	0.1111111111111111	0.	0.	0.1111111111111111
127	0.1457289859545864	0.06383298518146606	0.1111111111111111	0.	0.1111111111111111	0.	0.	0.1111111111111111
128	0.8999363531338685	0.8897357998705812	0.8888888888888888	0.8888888888888888	0.1111111111111111	0.	0.	0.1111111111111111
129	0.2848726800300951	0.870825234026278	0.2222222222222222	0.7777777777777778	0.1111111111111111	0.	0.	0.1111111111111111
130	0.7263304737951878	0.482625534724021	0.6666666666666666	0.4444444444444444	0.1111111111111111	0.	0.	0.1111111111111111
131	0.5642735671972511	0.29823415026801364	0.5555555555555556	0.2222222222222222	0.1111111111111111	0.	0.	0.1111111111111111
132	0.8685012586759018	0.1329546099457843	0.7777777777777778	0.1111111111111111	0.1111111111111111	0.	0.	0.1111111111111111
133	0.3341053756194087	0.698738567059455	0.3333333333333333	0.6666666666666666	0.1111111111111111	0.	0.	0.1111111111111111
134	0.04482249431745121	0.39385462135431876	0.	0.3333333333333333	0.1111111111111111	0.	0.	0.1111111111111111
135	0.5085929438285336	0.7160724653018202	0.4444444444444444	0.6666666666666666	0.1111111111111111	0.	0.	0.1111111111111111
136	0.21345318505685262	0.4277645806182441	0.1111111111111111	0.3333333333333333	0.1111111111111111	0.	0.	0.1111111111111111
137	0.9973281476774624	0.16564302135639852	0.8888888888888888	0.1111111111111111	0.1111111111111111	0.	0.	0.1111111111111111
138	0.2560262681409191	0.1052362583401382	0.2222222222222222	0.	0.1111111111111111	0.	0.	0.1111111111111111
139	0.676373234698316	0.9435443479259733	0.6666666666666666	0.8888888888888888	0.1111111111111111	0.	0.	0.1111111111111111
140	0.660613605286116	0.6257505033503792	0.5555555555555556	0.5555555555555556	0.1111111111111111	0.	0.	0.1111111111111111
141	0.8191713758329391	0.528231074015293	0.7777777777777778	0.4444444444444444	0.1111111111111111	0.	0.	0.1111111111111111
142	0.43143283696249396	0.2374303173900198	0.3333333333333333	0.2222222222222222	0.1111111111111111	0.	0.	0.1111111111111111
143	0.03639933371377957	0.7793186900861095	0.	0.7777777777777778	0.1111111111111111	0.	0.	0.1111111111111111
144	0.8598978081753785	0.7618663468949024	0.7777777777777778	0.6666666666666666	0.1111111111111111	0.	0.	0.1111111111111111
145	0.3676200202204587	0.35723356816749746	0.3333333333333333	0.3333333333333333	0.1111111111111111	0.	0.	0.1111111111111111
146	0.07211807272278778	0.2118759599211595	0.	0.1111111111111111	0.1111111111111111	0.	0.	0.1111111111111111
147	0.549979451396542	0.007924437195507575	0.4444444444444444	0.	0.1111111111111111	0.	0.	0.1111111111111111
148	0.1311646159908354	0.9803188639996443	0.1111111111111111	0.8888888888888888	0.1111111111111111	0.	0.	0.1111111111111111
149	0.9152776584307084	0.6571357166054961	0.8888888888888888	0.5555555555555556	0.1111111111111111	0.	0.	0.1111111111111111
150	0.2747567910207592	0.45338726952736536	0.2222222222222222	0.4444444444444444	0.1111111111111111	0.	0.	0.1111111111111111
151	0.7145409217975907	0.28713697689850376	0.6666666666666666	0.2222222222222222	0.1111111111111111	0.	0.	0.1111111111111111
152	0.589941645204693	0.8325959265412005	0.5555555555555556	0.7777777777777778	0.1111111111111111	0.	0.	0.1111111111111111
153	0.3049099854568266	0.675879400895599	0.2222222222222222	0.6666666666666666	0.1111111111111111	0.	0.	0.1111111111111111
154	0.7515610977404966	0.4059313677651158	0.6666666666666666	0.3333333333333333	0.1111111111111111	0.	0.	0.1111111111111111
155	0.6049342398099137	0.1443006206106978	0.5555555555555556	0.1111111111111111	0.1111111111111111	0.	0.	0.1111111111111111
156	0.7786617380820388	0.04642085841429689	0.7777777777777778	0.	0.1111111111111111	0.	0.	0.1111111111111111
157	0.37823599635864047	0.902267082558283	0.3333333333333333	0.8888888888888888	0.1111111111111111	0.	0.	0.1111111111111111
158	0.09449612253212557	0.5677401623777656	0.	0.5555555555555556	0.1111111111111111	0.	0.	0.1111111111111111
159	0.477830027724734	0.5002697245920139	0.4444444444444444	0.4444444444444444	0.1111111111111111	0.	0.	0.1111111111111111
160	0.1784379194255779	0.3090606848794378	0.1111111111111111	0.2222222222222222	0.1111111111111111	0.	0.	0.1111111111111111
161	0.9368870077149344	0.8767629779814425	0.8888888888888888	0.7777777777777778	0.1111111111111111	0.	0.	0.1111111111111111
162	0.7397465479254334	0.17333329609558504	0.6666666666666666	0.1111111111111111	0.1111111111111111	0.	0.	0.1111111111111111
163	0.5699710837957257	0.7310933599074572	0.5555555555555556	0.6666666666666666	0.1111111111111111	0.	0.	0.1111111111111111
164	0.2672438860093432	0.44119231907737333	0.2222222222222222	0.3333333333333333	0.1111111111111111	0.	0.	0.1111111111111111
165	0.35712695360311725	0.6002316585446947	0.3333333333333333	0.5555555555555556	0.1111111111111111	0.	0.	0.1111111111111111
166	0.05331539138086215	0.0805487436847117	0.	0.	0.1111111111111111	0.	0.	0.1111111111111111
167	0.8774138642247529	0.9612206226570188	0.7777777777777778	0.8888888888888888	0.1111111111111111	0.	0.	0.1111111111111111
168	0.1211916182367939	0.7921068779612221	0.1111111111111111	0.7777777777777778	0.1111111111111111	0.	0.	0.1111111111111111
169	0.9126970101986527	0.5350879287130321	0.8888888888888888	0.4444444444444444	0.1111111111111111	0.	0.	0.1111111111111111
170	0.5418689450538241	0.2582654510389958	0.4444444444444444	0.2222222222222222	0.1111111111111111	0.	0.	0.1111111111111111
171	0.16873079902252322	0.18671674159528862	0.1111111111111111	0.1111111111111111	0.1111111111111111	0.	0.	0.1111111111111111
172	0.9507371072467982	0.7730538347099828	0.8888888888888888	0.6666666666666666	0.1111111111111111	0.	0.	0.1111111111111111
173	0.46092160087072737	0.3673975780184753	0.4444444444444444	0.3333333333333333	0.1111111111111111	0.	0.	0.1111111111111111
174	0.7751361269210865	0.6398570451789745	0.6666666666666666	0.5555555555555556	0.1111111111111111	0.	0.	0.1111111111111111
175	0.6242741901035597	0.02269805095414042	0.5555555555555556	0.	0.1111111111111111	0.	0.	0.1111111111111111
176	0.32571932456571767	0.9932691066320966	0.2222222222222222	0.8888888888888888	0.1111111111111111	0.	0.	0.1111111111111111
177	0.4012279846149283	0.8508035120121556	0.3333333333333333	0.7777777777777778	0.1111111111111111	0.	0.	0.1111111111111111
178	0.07684805315842069	0.4574436227093814	0.	0.4444444444444444	0.1111111111111111	0.	0.	0.1111111111111111
179	0.8103285807375046	0.2593741834856855	0.7777777777777778	0.2222222222222222	0.1111111111111111	0.	0.	0.1111111111111111
180	0.4163098758224598	0.1196535839383549	0.3333333333333333	0.1111111111111111	0.1111111111111111	0.	0.	0.1111111111111111
181	0.01690475642345287	0.679249300966458	0.	0.6666666666666666	0.1111111111111111	0.	0.	0.1111111111111111
182	0.8437187602297067	0.38266734863713764	0.7777777777777778	0.3333333333333333	0.1111111111111111	0.	0.	0.1111111111111111
183	0.2076298946939105	0.5800272564658638	0.1111111111111111	0.5555555555555556	0.1111111111111111	0.	0.	0.1111111111111111
184	0.9857080644315983	0.051230875917871246	0.8888888888888888	0.	0.1111111111111111	0.	0.	0.1111111111111111
185	0.4983639847366634	0.9207430826750449	0.4444444444444444	0.8888888888888888	0.1111111111111111	0.	0.	0.1111111111111111
186	0.6994332162609672	0.8618432258496272	0.6666666666666666	0.7777777777777778	0.1111111111111111	0.	0.	0.1111111111111111
187	0.6495014619632057	0.5096775311058299	0.5555555555555556	0.4444444444444444	0.1111111111111111	0.	0.	0.1111111111111111
188	0.23745907769994073	0.32834695706211525	0.2222222222222222	0.2222222222222222	0.1111111111111111	0.	0.	0.1111111111111111
189	0.38847762557717147	0.5496581863364829	0.3333333333333333	0.4444444444444444	0.1111111111111111	0.	0.	0.1111111111111111
190	0.10398548126348581	0.22440663775356842	0.	0.2222222222222222	0.1111111111111111	0.	0.	0.1111111111111111
191	0.7960288371153581	0.8073780510181879	0.7777777777777778	0.7777777777777778	0.1111111111111111	0.	0.	0.1111111111111111
192	0.1588803649118998	0.709119493677579	0.1111111111111111	0.6666666666666666	0.1111111111111111	0.	0.	0.1111111111111111
193	0.944734995675461	0.41378928034271667	0.8888888888888888	0.3333333333333333	0.1111111111111111	0.	0.	0.1111111111111111
194	0.45053991796838955	0.15739477664366214	0.4444444444444444	0.1111111111111111	0.1111111111111111	0.	0.	0.1111111111111111
195	0.7532004491722515	0.09715167731702837	0.6666666666666666	0.	0.1111111111111111	0.	0.	0.1111111111111111
196	0.6167384305101462	0.937074208277095	0.5555555555555556	0.8888888888888888	0.1111111111111111	0.	0.	0.1111111111111111
197	0.3141555763200743	0.6096416797064822	0.2222222222222222	0.5555555555555556	0.1111111111111111	0.	0.	0.1111111111111111
198	0.6859296463280237	0.4708883788539124	0.6666666666666666	0.4444444444444444	0.1111111111111111	0.	0.	0.1111111111111111
199	0.6404674250462783	0.28039356913481844	0.5555555555555556	0.2222222222222222	0.1111111111111111	0.	0.	0.1111111111111111
200	0.2294829576415786	0.8181742404783691	0.2222222222222222	0.7777777777777778	0.1111111111111111	0.	0.	0.1111111111111111
201	0.44159417013521285	0.7421876148286694	0.3333333333333333	0.6666666666666666	0.1111111111111111	0.	0.	0.1111111111111111
202	0.000011060333982491051	0.3390372856609553	0.	0.3333333333333333	0.1111111111111111	0.	0.	0.1111111111111111
203	0.8327487587610095	0.1983118924134478	0.7777777777777778	0.1111111111111111	0.1111111111111111	0.	0.	0.1111111111111111
204	0.1913300391640705	0.031221313818192684	0.1111111111111111	0.	0.1111111111111111	0.	0.	0.1111111111111111
205	0.9709960796626841	0.9645587424434506	0.8888888888888888	0.8888888888888888	0.1111111111111111	0.	0.	0.1111111111111111
206	0.48498487044826033	0.6537621091072445	0.4444444444444444	0.5555555555555556	0.1111111111111111	0.	0.	0.1111111111111111
207	0.13701104400461042	0.4883919015788897	0.1111111111111111	0.4444444444444444	0.1111111111111111	0.	0.	0.1111111111111111
208	0.8898719525388861	0.30099200131187004	0.8888888888888888	0.2222222222222222	0.1111111111111111	0.	0.	0.1111111111111111
209	0.5276444968815267	0.8739435564544963	0.4444444444444444	0.7777777777777778	0.1111111111111111	0.	0.	0.1111111111111111
210	0.7172595355430467	0.7005227258385914	0.6666666666666666	0.6666666666666666	0.1111111111111111	0.	0.	0.1111111111111111
211	0.558633893865467	0.3829836466565057	0.5555555555555556	0.3333333333333333	0.1111111111111111	0.	0.	0.1111111111111111
212	0.29110288915738447	0.1256397756839684	0.2222222222222222	0.1111111111111111	0.1111111111111111	0.	0.	0.1111111111111111
213	0.33852164953516434	0.06888769117216205	0.3333333333333333	0.	0.1111111111111111	0.	0.	0.1111111111111111
214	0.04869206508762284	0.8946402849299657	0.	0.8888888888888888	0.1111111111111111	0.	0.	0.1111111111111111