0	0.7060615647167454	0.6067106602270246	0.6666666666666666	0.5555555555555556	0.1111111111111111	0.	0.	0.1111111111111111
1	0.1432967638769702	0.9669569756114096	0.1111111111111111	0.8888888888888888	0.1111111111111111	0.	0.	0.1111111111111111
2	0.6295067037613491	0.3111736603756821	0.5555555555555556	0.2222222222222222	0.1111111111111111	0.	0.	0.1111111111111111
3	0.2537775116655399	0.07414793094917256	0.2222222222222222	0.	0.1111111111111111	0.	0.	0.1111111111111111
4	0.39263710013368275	0.41232872946995847	0.3333333333333333	0.3333333333333333	0.1111111111111111	0.	0.	0.1111111111111111
5	0.7999180471841283	0.7064120469546635	0.7777777777777778	0.6666666666666666	0.1111111111111111	0.	0.	0.1111111111111111
6	0.45236455817217597	0.8845524008067283	0.4444444444444444	0.7777777777777778	0.1111111111111111	0.	0.	0.1111111111111111
7	0.9546745637743835	0.1807744633764065	0.8888888888888888	0.1111111111111111	0.1111111111111111	0.	0.	0.1111111111111111
8	0.10768901452361411	0.5052365433018353	0.	0.4444444444444444	0.1111111111111111	0.	0.	0.1111111111111111
9	0.27501777016238294	0.6328032563089353	0.2222222222222222	0.5555555555555556	0.1111111111111111	0.	0.	0.1111111111111111
10	0.4204949685387789	0.8997470902130493	0.3333333333333333	0.8888888888888888	0.1111111111111111	0.	0.	0.1111111111111111
11	0.8203427792035716	0.2589936219575281	0.7777777777777778	0.2222222222222222	0.1111111111111111	0.	0.	0.1111111111111111
12	0.4841515046114834	0.02934635189105861	0.4444444444444444	0.	0.1111111111111111	0.	0.	0.1111111111111111
13	0.9992287466930194	0.3514999452356447	0.8888888888888888	0.3333333333333333	0.1111111111111111	0.	0.	0.1111111111111111
14	0.014624383138049951	0.7614039096419601	0.	0.6666666666666666	0.1111111111111111	0.	0.	0.1111111111111111
15	0.7458237949137826	0.7973164828323437	0.6666666666666666	0.7777777777777778	0.1111111111111111	0.	0.	0.1111111111111111
16	0.1792076240276836	0.20744124781347503	0.1111111111111111	0.1111111111111111	0.1111111111111111	0.	0.	0.1111111111111111
17	0.6346960421083976	0.5423336356723595	0.5555555555555556	0.4444444444444444	0.1111111111111111	0.	0.	0.1111111111111111
18	0.5368199107645372	0.5608360584150727	0.4444444444444444	0.5555555555555556	0.1111111111111111	0.	0.	0.1111111111111111
19	0.9248217569962681	0.9342794412713676	0.8888888888888888	0.8888888888888888	0.1111111111111111	0.	0.	0.1111111111111111
20	0.07189856961850048	0.2809914191192919	0.	0.2222222222222222	0.1111111111111111	0.	0.	0.1111111111111111
21	0.6963333216999786	0.04437151662019266	0.6666666666666666	0.	0.1111111111111111	0.	0.	0.1111111111111111
22	0.1977718693482247	0.40431543361146294	0.1111111111111111	0.3333333333333333	0.1111111111111111	0.	0.	0.1111111111111111
23	0.578174882399332	0.6684824990416723	0.5555555555555556	0.6666666666666666	0.1111111111111111	0.	0.	0.1111111111111111
24	0.2995612285922923	0.8324408813942037	0.2222222222222222	0.7777777777777778	0.1111111111111111	0.	0.	0.1111111111111111
25	0.3394630409785409	0.1303684457431987	0.3333333333333333	0.1111111111111111	0.1111111111111111	0.	0.	0.1111111111111111
26	0.8756827029868316	0.44489500485177846	0.7777777777777778	0.4444444444444444	0.1111111111111111	0.	0.	0.1111111111111111
27	0.1557918541921342	0.5791486667259529	0.1111111111111111	0.5555555555555556	0.1111111111111111	0.	0.	0.1111111111111111
28	0.6489765895336184	0.9481112850143213	0.5555555555555556	0.8888888888888888	0.1111111111111111	0.	0.	0.1111111111111111
29	0.7557150580472614	0.28663744988458784	0.6666666666666666	0.2222222222222222	0.1111111111111111	0.	0.	0.1111111111111111
30	0.44303722408444957	0.06030448396513863	0.3333333333333333	0.	0.1111111111111111	0.	0.	0.1111111111111111
31	0.8316261077594514	0.3722047545089955	0.7777777777777778	0.3333333333333333	0.1111111111111111	0.	0.	0.1111111111111111
32	0.28773791310763647	0.6867015956918066	0.2222222222222222	0.6666666666666666	0.1111111111111111	0.	0.	0.1111111111111111
33	0.9739287915324135	0.8443353779360906	0.8888888888888888	0.7777777777777778	0.1111111111111111	0.	0.	0.1111111111111111
34	0.0326366425086	0.14125949595815002	0.	0.1111111111111111	0.1111111111111111	0.	0.	0.1111111111111111
35	0.5055665008982012	0.46105907940248353	0.4444444444444444	0.4444444444444444	0.1111111111111111	0.	0.	0.1111111111111111
36	0.35655123375091646	0.6222461412807038	0.3333333333333333	0.5555555555555556	0.1111111111111111	0.	0.	0.1111111111111111
37	0.879697084545951	0.9801445417789112	0.7777777777777778	0.8888888888888888	0.1111111111111111	0.	0.	0.1111111111111111
38	0.3153981960239934	0.33267215766691166	0.2222222222222222	0.2222222222222222	0.1111111111111111	0.	0.	0.1111111111111111
39	0.8919478124624087	0.09411921508708161	0.8888888888888888	0.	0.1111111111111111	0.	0.	0.1111111111111111
40	0.04262683432832072	0.42343139041707567	0.	0.3333333333333333	0.1111111111111111	0.	0.	0.1111111111111111
41	0.5523451798303488	0.7260859126460225	0.4444444444444444	0.6666666666666666	0.1111111111111111	0.	0.	0.1111111111111111
42	0.21378537278823853	0.8547837962522766	0.1111111111111111	0.7777777777777778	0.1111111111111111	0.	0.	0.1111111111111111
43	0.5848585798465605	0.15965002907560044	0.5555555555555556	0.1111111111111111	0.1111111111111111	0.	0.	0.1111111111111111
44	0.6740301689791804	0.5076849639720526	0.6666666666666666	0.4444444444444444	0.1111111111111111	0.	0.	0.1111111111111111
45	0.9277094574795879	0.644307291656947	0.8888888888888888	0.5555555555555556	0.1111111111111111	0.	0.	0.1111111111111111
46	0.07656347175450152	0.9058527447507645	0.	0.8888888888888888	0.1111111111111111	0.	0.	0.1111111111111111
47	0.46045556632051715	0.23028907831803744	0.4444444444444444	0.2222222222222222	0.1111111111111111	0.	0.	0.1111111111111111
48	0.11612222191996671	0.001495614411520364	0.1111111111111111	0.	0.1111111111111111	0.	0.	0.1111111111111111
49	0.6016653643392275	0.35882862061708537	0.5555555555555556	0.3333333333333333	0.1111111111111111	0.	0.	0.1111111111111111
50	0.7260172482342135	0.7709653967217	0.6666666666666666	0.6666666666666666	0.1111111111111111	0.	0.	0.1111111111111111
51	0.39935148688879324	0.8079015218698635	0.3333333333333333	0.7777777777777778	0.1111111111111111	0.	0.	0.1111111111111111
52	0.8140915773817012	0.219009422773886	0.7777777777777778	0.1111111111111111	0.1111111111111111	0.	0.	0.1111111111111111
53	0.22499210412178283	0.555347304652577	0.2222222222222222	0.4444444444444444	0.1111111111111111	0.	0.	0.1111111111111111
54	0.5564425642272455	0.6664987405970674	0.5555555555555556	0.5555555555555556	0.1111111111111111	0.	0.	0.1111111111111111
55	0.687196026606292	0.9222641973727244	0.6666666666666666	0.8888888888888888	0.1111111111111111	0.	0.	0.1111111111111111
56	0.1862092507967486	0.24647003203109724	0.1111111111111111	0.2222222222222222	0.1111111111111111	0.	0.	0.1111111111111111
57	0.8640204777605348	0.022655545888453685	0.7777777777777778	0.	0.1111111111111111	0.	0.	0.1111111111111111
58	0.33140664724454816	0.3435748420970408	0.2222222222222222	0.3333333333333333	0.1111111111111111	0.	0.	0.1111111111111111
59	0.3665741608897372	0.7419709011139403	0.3333333333333333	0.6666666666666666	0.1111111111111111	0.	0.	0.1111111111111111
60	0.05537811312469503	0.7869110101023421	0.	0.7777777777777778	0.1111111111111111	0.	0.	0.1111111111111111
61	0.5221250133727441	0.1970471787137033	0.4444444444444444	0.1111111111111111	0.1111111111111111	0.	0.	0.1111111111111111
62	0.9107762350001405	0.525969834978621	0.8888888888888888	0.4444444444444444	0.1111111111111111	0.	0.	0.1111111111111111
63	0.7848142211532166	0.5869656728454546	0.7777777777777778	0.5555555555555556	0.1111111111111111	0.	0.	0.1111111111111111
64	0.23611292793551764	0.9547073360903223	0.2222222222222222	0.8888888888888888	0.1111111111111111	0.	0.	0.1111111111111111
65	0.3766657111415705	0.2653467913687618	0.3333333333333333	0.2222222222222222	0.1111111111111111	0.	0.	0.1111111111111111
66	0.0911995906339378	0.06568801613725013	0.	0.	0.1111111111111111	0.	0.	0.1111111111111111
67	0.4748455323263333	0.3883624174215181	0.4444444444444444	0.3333333333333333	0.1111111111111111	0.	0.	0.1111111111111111
68	0.9403702463105059	0.6989706034881392	0.8888888888888888	0.6666666666666666	0.1111111111111111	0.	0.	0.1111111111111111
69	0.6100024487863367	0.8175866773358322	0.5555555555555556	0.7777777777777778	0.1111111111111111	0.	0.	0.1111111111111111
70	0.7352271870508464	0.11369834994280162	0.6666666666666666	0.1111111111111111	0.1111111111111111	0.	0.	0.1111111111111111
71	0.13485276458881354	0.47259005016983846	0.1111111111111111	0.4444444444444444	0.1111111111111111	0.	0.	0.1111111111111111
72	0.0025250333796018386	0.6025792473424572	0.	0.5555555555555556	0.1111111111111111	0.	0.	0.1111111111111111
73	0.5079178315390198	0.9980321983779575	0.4444444444444444	0.8888888888888888	0.1111111111111111	0.	0.	0.1111111111111111
74	0.9785353986961354	0.3002165983362158	0.8888888888888888	0.2222222222222222	0.1111111111111111	0.	0.	0.1111111111111111
75	0.659152171651579	0.10898262877710971	0.5555555555555556	0.	0.1111111111111111	0.	0.	0.1111111111111111
76	0.768225927083927	0.438246112825833	0.6666666666666666	0.3333333333333333	0.1111111111111111	0.	0.	0.1111111111111111
77	0.1700826815761586	0.7314004818504406	0.1111111111111111	0.6666666666666666	0.1111111111111111	0.	0.	0.1111111111111111
78	0.843343462577341	0.8759881514681584	0.7777777777777778	0.7777777777777778	0.1111111111111111	0.	0.	0.1111111111111111
79	0.2640168883788694	0.17155465672854492	0.2222222222222222	0.1111111111111111	0.1111111111111111	0.	0.	0.1111111111111111
80	0.41472992496618677	0.48197520429368246	0.3333333333333333	0.4444444444444444	0.1111111111111111	0.	0.	0.1111111111111111
81	0.7415395825042869	0.5453132827641097	0.6666666666666666	0.4444444444444444	0.1111111111111111	0.	0.	0.1111111111111111
82	0.17669259786274924	0.8145550040849803	0.1111111111111111	0.7777777777777778	0.1111111111111111	0.	0.	0.1111111111111111
83	0.6304659724213331	0.2131461663608607	0.5555555555555556	0.1111111111111111	0.1111111111111111	0.	0.	0.1111111111111111
84	0.2824366249079134	0.23417322498225782	0.2222222222222222	0.2222222222222222	0.1111111111111111	0.	0.	0.1111111111111111
85	0.42896521407260935	0.6497848396792801	0.3333333333333333	0.5555555555555556	0.1111111111111111	0.	0.	0.1111111111111111
86	0.816320461392359	0.9133165850709565	0.7777777777777778	0.8888888888888888	0.1111111111111111	0.	0.	0.1111111111111111
87	0.49261886525228843	0.7764886943464333	0.4444444444444444	0.6666666666666666	0.1111111111111111	0.	0.	0.1111111111111111
88	0.9920002389617206	0.0063664211626143505	0.8888888888888888	0.	0.1111111111111111	0.	0.	0.1111111111111111
89	0.02062792209904693	0.3625824282790235	0.	0.3333333333333333	0.1111111111111111	0.	0.	0.1111111111111111
90	0.30720324654796466	0.46527616922191234	0.2222222222222222	0.4444444444444444	0.1111111111111111	0.	0.	0.1111111111111111
91	0.3352882376853333	0.8484441143397211	0.3333333333333333	0.7777777777777778	0.1111111111111111	0.	0.	0.1111111111111111
92	0.8714559587132901	0.14616515717284811	0.7777777777777778	0.1111111111111111	0.1111111111111111	0.	0.	0.1111111111111111
93	0.5349139850646017	0.2898581941889329	0.4444444444444444	0.2222222222222222	0.1111111111111111	0.	0.	0.1111111111111111
94	0.9211858978372206	0.5705424483456614	0.8888888888888888	0.5555555555555556	0.1111111111111111	0.	0.	0.1111111111111111
95	0.06854379351113771	0.9401627379254759	0.	0.8888888888888888	0.1111111111111111	0.	0.	0.1111111111111111
96	0.6920194206180287	0.6885315582780136	0.6666666666666666	0.6666666666666666	0.1111111111111111	0.	0.	0.1111111111111111
97	0.20920228356843562	0.05252954325121751	0.1111111111111111	0.	0.1111111111111111	0.	0.	0.1111111111111111
98	0.572233725270701	0.3756839096860466	0.5555555555555556	0.3333333333333333	0.1111111111111111	0.	0.	0.1111111111111111
99	0.44749018337712815	0.51096974722298	0.4444444444444444	0.4444444444444444	0.1111111111111111	0.	0.	0.1111111111111111
100	0.9601089975737792	0.8576245701174916	0.8888888888888888	0.7777777777777778	0.1111111111111111	0.	0.	0.1111111111111111
101	0.10670196726052181	0.15181876454654933	0.	0.1111111111111111	0.1111111111111111	0.	0.	0.1111111111111111
102	0.7142664697839458	0.32264505762884427	0.6666666666666666	0.2222222222222222	0.1111111111111111	0.	0.	0.1111111111111111
103	0.13868808833184862	0.6292799991793929	0.1111111111111111	0.5555555555555556	0.1111111111111111	0.	0.	0.1111111111111111
104	0.6226592135657545	0.9862673232717609	0.5555555555555556	0.8888888888888888	0.1111111111111111	0.	0.	0.1111111111111111
105	0.24760127060118742	0.7183553277001139	0.2222222222222222	0.6666666666666666	0.1111111111111111	0.	0.	0.1111111111111111
106	0.39000972059241473	0.0967287389215322	0.3333333333333333	0.	0.1111111111111111	0.	0.	0.1111111111111111
107	0.7969371921025754	0.42467381395171044	0.7777777777777778	0.3333333333333333	0.1111111111111111	0.	0.	0.1111111111111111
108	0.22192417052745672	0.48738200317536645	0.1111111111111111	0.4444444444444444	0.1111111111111111	0.	0.	0.1111111111111111
109	0.5805894053614015	0.8642536636723929	0.5555555555555556	0.7777777777777778	0.1111111111111111	0.	0.	0.1111111111111111
110	0.6693090325087754	0.16340202905479273	0.6666666666666666	0.1111111111111111	0.1111111111111111	0.	0.	0.1111111111111111
111	0.35045288996060303	0.3025663243467057	0.3333333333333333	0.2222222222222222	0.1111111111111111	0.	0.	0.1111111111111111
112	0.8885747057120668	0.5961836193266828	0.7777777777777778	0.5555555555555556	0.1111111111111111	0.	0.	0.1111111111111111
113	0.3100749428871843	0.9878104123708337	0.2222222222222222	0.8888888888888888	0.1111111111111111	0.	0.	0.1111111111111111
114	0.8971739050177081	0.7328632886699668	0.8888888888888888	0.6666666666666666	0.1111111111111111	0.	0.	0.1111111111111111
115	0.03847642141611152	0.09978978249994759	0.	0.	0.1111111111111111	0.	0.	0.1111111111111111
116	0.5479769415774669	0.44115969560918084	0.4444444444444444	0.3333333333333333	0.1111111111111111	0.	0.	0.1111111111111111
117	0.3952184710946801	0.5277243945660293	0.3333333333333333	0.4444444444444444	0.1111111111111111	0.	0.	0.1111111111111111
118	0.8074814795524836	0.7793631060815337	0.7777777777777778	0.7777777777777778	0.1111111111111111	0.	0.	0.1111111111111111
119	0.23046125902408504	0.18871388515197163	0.2222222222222222	0.1111111111111111	0.1111111111111111	0.	0.	0.1111111111111111
120	0.9359668378303038	0.23595629192445733	0.8888888888888888	0.2222222222222222	0.1111111111111111	0.	0.	0.1111111111111111
121	0.08299798344772967	0.6552164247220974	0.	0.5555555555555556	0.1111111111111111	0.	0.	0.1111111111111111
122	0.467078451289653	0.915003165118267	0.4444444444444444	0.8888888888888888	0.1111111111111111	0.	0.	0.1111111111111111
123	0.1134804781409827	0.7460793621922597	0.1111111111111111	0.6666666666666666	0.1111111111111111	0.	0.	0.1111111111111111
124	0.5996267266769845	0.012532353875240362	0.5555555555555556	0.	0.1111111111111111	0.	0.	0.1111111111111111
125	0.7205404083141647	0.33384066323864464	0.6666666666666666	0.3333333333333333	0.1111111111111111	0.	0.	0.1111111111111111
126	0.970677190143825	0.4741411426315487	0.8888888888888888	0.4444444444444444	0.1111111111111111	0.	0.	0.1111111111111111
127	0.025322726284618364	0.8227393595592721	0.	0.7777777777777778	0.1111111111111111	0.	0.	0.1111111111111111
128	0.49840287443685855	0.11621867611997501	0.4444444444444444	0.1111111111111111	0.1111111111111111	0.	0.	0.1111111111111111
129	0.1507127302879086	0.2711388400524166	0.1111111111111111	0.2222222222222222	0.1111111111111111	0.	0.	0.1111111111111111
130	0.6442508921273565	0.590114045310598	0.5555555555555556	0.5555555555555556	0.1111111111111111	0.	0.	0.1111111111111111
131	0.7651941626315657	0.9563052915011593	0.6666666666666666	0.8888888888888888	0.1111111111111111	0.	0.	0.1111111111111111
132	0.4375830090218418	0.7026294299404835	0.3333333333333333	0.6666666666666666	0.1111111111111111	0.	0.	0.1111111111111111
133	0.8278762983372657	0.06874359106667347	0.7777777777777778	0.	0.1111111111111111	0.	0.	0.1111111111111111
134	0.2925605155591036	0.392613910859354	0.2222222222222222	0.3333333333333333	0.1111111111111111	0.	0.	0.1111111111111111
135	0.6057486219664892	0.45209762081874133	0.5555555555555556	0.4444444444444444	0.1111111111111111	0.	0.	0.1111111111111111
136	0.729507038711798	0.8357541263991677	0.6666666666666666	0.7777777777777778	0.1111111111111111	0.	0.	0.1111111111111111
137	0.1313656456271384	0.1354371597694893	0.1111111111111111	0.1111111111111111	0.1111111111111111	0.	0.	0.1111111111111111
138	0.779557121805536	0.27568171026700666	0.7777777777777778	0.2222222222222222	0.1111111111111111	0.	0.	0.1111111111111111
139	0.24417064409139533	0.5667407745179942	0.2222222222222222	0.5555555555555556	0.1111111111111111	0.	0.	0.1111111111111111
140	0.3705096677699631	0.927875713529097	0.3333333333333333	0.8888888888888888	0.1111111111111111	0.	0.	0.1111111111111111
141	0.08671816098330652	0.6721204893907062	0.	0.6666666666666666	0.1111111111111111	0.	0.	0.1111111111111111
142	0.4695071036025322	0.04613882807146355	0.4444444444444444	0.	0.1111111111111111	0.	0.	0.1111111111111111
143	0.9501247037384576	0.3958847497436651	0.8888888888888888	0.3333333333333333	0.1111111111111111	0.	0.	0.1111111111111111
144	0.850472004850523	0.49545821861097633	0.7777777777777778	0.4444444444444444	0.1111111111111111	0.	0.	0.1111111111111111
145	0.2611532272367763	0.8857533121675797	0.2222222222222222	0.7777777777777778	0.1111111111111111	0.	0.	0.1111111111111111
146	0.409953899813836	0.1832603325908937	0.3333333333333333	0.1111111111111111	0.1111111111111111	0.	0.	0.1111111111111111
147	0.008581372852138098	0.3136929084821842	0.	0.2222222222222222	0.1111111111111111	0.	0.	0.1111111111111111
148	0.5176409999661462	0.6119559773721724	0.4444444444444444	0.5555555555555556	0.1111111111111111	0.	0.	0.1111111111111111
149	0.9853811698293188	0.9691051927474768	0.8888888888888888	0.8888888888888888	0.1111111111111111	0.	0.	0.1111111111111111
150	0.6567688370245179	0.7113237266085843	0.5555555555555556	0.6666666666666666	0.1111111111111111	0.	0.	0.1111111111111111
151	0.7771579490899531	0.08001816771922629	0.6666666666666666	0.	0.1111111111111111	0.	0.	0.1111111111111111
152	0.1665653095251415	0.4181035359060046	0.1111111111111111	0.3333333333333333	0.1111111111111111	0.	0.	0.1111111111111111
153	0.05161408056901537	0.5348431180503036	0.	0.4444444444444444	0.1111111111111111	0.	0.	0.1111111111111111
154	0.5308459434627373	0.7996090822823433	0.4444444444444444	0.7777777777777778	0.1111111111111111	0.	0.	0.1111111111111111
155	0.9080806530773511	0.20120341045428464	0.8888888888888888	0.1111111111111111	0.1111111111111111	0.	0.	0.1111111111111111
156	0.5654540494200174	0.2486403655331714	0.5555555555555556	0.2222222222222222	0.1111111111111111	0.	0.	0.1111111111111111
157	0.6816755605303053	0.6367738998612091	0.6666666666666666	0.5555555555555556	0.1111111111111111	0.	0.	0.1111111111111111
158	0.19518903916307842	0.8907400334558282	0.1111111111111111	0.8888888888888888	0.1111111111111111	0.	0.	0.1111111111111111
159	0.8580657204219264	0.7535459351161644	0.7777777777777778	0.6666666666666666	0.1111111111111111	0.	0.	0.1111111111111111
160	0.32539961853523275	0.03361138273028542	0.2222222222222222	0.	0.1111111111111111	0.	0.	0.1111111111111111
161	0.3653438198343024	0.35629126384863624	0.3333333333333333	0.3333333333333333	0.1111111111111111	0.	0.	0.1111111111111111
162	0.7016919506976996	0.38634591591428896	0.6666666666666666	0.3333333333333333	0.1111111111111111	0.	0.	0.1111111111111111
163	0.20264693503772502	0.6954530739854597	0.1111111111111111	0.6666666666666666	0.1111111111111111	0.	0.	0.1111111111111111
164	0.5681035556519917	0.07312377327570821	0.5555555555555556	0.	0.1111111111111111	0.	0.	0.1111111111111111
165	0.3043028767983755	0.12163816577771822	0.2222222222222222	0.1111111111111111	0.1111111111111111	0.	0.	0.1111111111111111
166	0.34455845725805173	0.47812096570177354	0.3333333333333333	0.4444444444444444	0.1111111111111111	0.	0.	0.1111111111111111
167	0.8657034286760881	0.8238091980038086	0.7777777777777778	0.7777777777777778	0.1111111111111111	0.	0.	0.1111111111111111
168	0.540527258140616	0.958959921365095	0.4444444444444444	0.8888888888888888	0.1111111111111111	0.	0.	0.1111111111111111
169	0.9169068753098394	0.2595763927188683	0.8888888888888888	0.2222222222222222	0.1111111111111111	0.	0.	0.1111111111111111
170	0.06297543115571601	0.5839798980447487	0.	0.5555555555555556	0.1111111111111111	0.	0.	0.1111111111111111
171	0.2561463056746077	0.434491567808296	0.2222222222222222	0.3333333333333333	0.1111111111111111	0.	0.	0.1111111111111111
172	0.38510515551661156	0.7403802857038192	0.3333333333333333	0.6666666666666666	0.1111111111111111	0.	0.	0.1111111111111111
173	0.791533833066497	0.10504675450967181	0.7777777777777778	0.	0.1111111111111111	0.	0.	0.1111111111111111
174	0.45585414645773503	0.16779913000419552	0.4444444444444444	0.1111111111111111	0.1111111111111111	0.	0.	0.1111111111111111
175	0.9563733278271024	0.4934875828590127	0.8888888888888888	0.4444444444444444	0.1111111111111111	0.	0.	0.1111111111111111
176	0.10259882770423122	0.8694701207021949	0.	0.7777777777777778	0.1111111111111111	0.	0.	0.1111111111111111
177	0.7104273233210442	0.9928962542126505	0.6666666666666666	0.8888888888888888	0.1111111111111111	0.	0.	0.1111111111111111
178	0.14574754029938083	0.30482596477579005	0.1111111111111111	0.2222222222222222	0.1111111111111111	0.	0.	0.1111111111111111
179	0.6175954717425042	0.5977545412335347	0.5555555555555556	0.5555555555555556	0.1111111111111111	0.	0.	0.1111111111111111
180	0.48648276575790494	0.34103445502938634	0.4444444444444444	0.3333333333333333	0.1111111111111111	0.	0.	0.1111111111111111
181	0.9907322136147184	0.7491614311601367	0.8888888888888888	0.6666666666666666	0.1111111111111111	0.	0.	0.1111111111111111
182	0.017701810293259942	0.01908329634058151	0.	0.	0.1111111111111111	0.	0.	0.1111111111111111
183	0.7526011227557974	0.19212141789090223	0.6666666666666666	0.1111111111111111	0.1111111111111111	0.	0.	0.1111111111111111
184	0.18221121151562714	0.5220872215322269	0.1111111111111111	0.4444444444444444	0.1111111111111111	0.	0.	0.1111111111111111
185	0.6389687984037762	0.7843303549871538	0.5555555555555556	0.7777777777777778	0.1111111111111111	0.	0.	0.1111111111111111
186	0.2791478761121141	0.9194127907881506	0.2222222222222222	0.8888888888888888	0.1111111111111111	0.	0.	0.1111111111111111
187	0.4249842372172526	0.2403488353795696	0.3333333333333333	0.2222222222222222	0.1111111111111111	0.	0.	0.1111111111111111
188	0.8234996480357376	0.6597683978797864	0.7777777777777778	0.5555555555555556	0.1111111111111111	0.	0.	0.1111111111111111
189	0.1234287250099465	0.3490986791873055	0.1111111111111111	0.3333333333333333	0.1111111111111111	0.	0.	0.1111111111111111