0	0.018656	0.0427471	0	0	0.111111	0 	0 	0.111111	
192	0.0269575	0.0416936	0	0	0.111111	0 	0 	0.111111	
141	0.0839927	0.0797165	0	0	0.111111	0 	0 	0.111111	
131	0.167168	0.0976231	0.111111	0.111111	0.111111	0 	0 	-0.111111	
80	0.13951	0.0497584	0.111111	0.111111	0.111111	0 	0 	-0.111111	
182	0.209388	0.0510014	0.111111	0.111111	0.111111	0 	0 	-0.111111	
91	0.263544	0.0214467	0.222222	0	0.111111	0 	0 	0.111111	
40	0.320314	0.0390182	0.222222	0	0.111111	0 	0 	0.111111	
17	0.333291	0.134536	0.333333	0.111111	-0.111111	0 	0 	0.111111	
149	0.222874	0.145088	0.333333	0.111111	-0.111111	0 	0 	0.111111	
105	0.221758	0.21069	0.222222	0.222222	-0.111111	0 	0 	-0.111111	
45	0.200651	0.168284	0.222222	0.222222	-0.111111	0 	0 	-0.111111	
58	0.0961816	0.150902	0.111111	0.111111	-0.111111	0 	0 	0.111111	
109	0.110932	0.181453	0.111111	0.111111	-0.111111	0 	0 	0.111111	
169	0.0236327	0.214119	0.111111	0.111111	-0.111111	0 	0 	0.111111	
86	0.0270692	0.293955	0	0.222222	0.111111	0 	0 	0.111111	
35	0.0417782	0.303366	0	0.222222	0.111111	0 	0 	0.111111	
154	0.139332	0.289584	0.111111	0.333333	0.111111	0 	0 	-0.111111	
22	0.124225	0.318868	0.111111	0.333333	0.111111	0 	0 	-0.111111	
63	0.24385	0.235512	0.222222	0.222222	0.111111	0 	0 	0.111111	
174	0.289962	0.286779	0.222222	0.222222	0.111111	0 	0 	0.111111	
123	0.236689	0.238555	0.222222	0.222222	0.111111	0 	0 	0.111111	
97	0.333977	0.244161	0.333333	0.333333	0.111111	0 	0 	-0.111111	
37	0.419456	0.269458	0.333333	0.333333	0.111111	0 	0 	-0.111111	
120	0.427785	0.18024	0.444444	0.222222	-0.111111	0 	0 	-0.111111	
171	0.413484	0.175576	0.444444	0.222222	-0.111111	0 	0 	-0.111111	
69	0.362254	0.144411	0.444444	0.222222	-0.111111	0 	0 	-0.111111	
146	0.343674	0.0726952	0.333333	0.111111	0.111111	0 	0 	-0.111111	
14	0.392185	0.0830242	0.333333	0.111111	0.111111	0 	0 	-0.111111	
115	0.463905	0.0253928	0.444444	0	0.111111	0 	0 	0.111111	
55	0.529515	0.059195	0.444444	0	0.111111	0 	0 	0.111111	
166	0.487039	0.0869092	0.444444	0	0.111111	0 	0 	0.111111	
32	0.542049	0.167247	0.555556	0.111111	-0.111111	0 	0 	0.111111	
83	0.530102	0.1685	0.555556	0.111111	-0.111111	0 	0 	0.111111	
6	0.463016	0.30101	0.444444	0.222222	0.111111	0 	0 	0.111111	
189	0.482268	0.257172	0.444444	0.222222	0.111111	0 	0 	0.111111	
138	0.522634	0.304527	0.444444	0.222222	0.111111	0 	0 	0.111111	
128	0.570049	0.248398	0.555556	0.333333	0.111111	0 	0 	-0.111111	
77	0.614584	0.329901	0.555556	0.333333	0.111111	0 	0 	-0.111111	
188	0.662551	0.251029	0.555556	0.333333	0.111111	0 	0 	-0.111111	
19	0.624448	0.167474	0.666667	0.222222	-0.111111	0 	0 	-0.111111	
160	0.608118	0.133931	0.666667	0.222222	-0.111111	0 	0 	-0.111111	
51	0.555584	0.0104618	0.555556	0.111111	0.111111	0 	0 	-0.111111	
102	0.655085	0.096251	0.555556	0.111111	0.111111	0 	0 	-0.111111	
157	0.667192	0.0264433	0.666667	0	0.111111	0 	0 	0.111111	
25	0.723473	0.0367495	0.666667	0	0.111111	0 	0 	0.111111	
66	0.82012	0.000303504	0.777778	0.111111	0.111111	0 	0 	-0.111111	
177	0.814237	0.0836581	0.777778	0.111111	0.111111	0 	0 	-0.111111	
117	0.778934	0.10981	0.777778	0.111111	0.111111	0 	0 	-0.111111	
89	0.917697	0.000292698	0.888889	0	0.111111	0 	0 	0.111111	
29	0.945324	0.0768502	0.888889	0	0.111111	0 	0 	0.111111	
135	0.985485	0.111418	1	0.111111	-0.111111	0 	0 	0.111111	
195	0.915995	0.144956	1	0.111111	-0.111111	0 	0 	0.111111	
3	0.902837	0.112264	1	0.111111	-0.111111	0 	0 	0.111111	
43	0.874577	0.167214	0.888889	0.222222	-0.111111	0 	0 	-0.111111	
94	0.860798	0.202683	0.888889	0.222222	-0.111111	0 	0 	-0.111111	
185	0.722015	0.125223	0.777778	0.111111	-0.111111	0 	0 	0.111111	
74	0.733102	0.205242	0.777778	0.111111	-0.111111	0 	0 	0.111111	
134	0.724128	0.182007	0.777778	0.111111	-0.111111	0 	0 	0.111111	
48	0.682843	0.236806	0.666667	0.222222	0.111111	0 	0 	0.111111	
99	0.762023	0.319377	0.666667	0.222222	0.111111	0 	0 	0.111111	
152	0.791669	0.277065	0.777778	0.333333	0.111111	0 	0 	-0.111111	
11	0.807075	0.285519	0.777778	0.333333	0.111111	0 	0 	-0.111111	
112	0.958975	0.256604	0.888889	0.222222	0.111111	0 	0 	0.111111	
61	0.902871	0.230361	0.888889	0.222222	0.111111	0 	0 	0.111111	
163	0.916184	0.331316	0.888889	0.222222	0.111111	0 	0 	0.111111	
104	0.972175	0.333641	1	0.333333	-0.111111	0 	0 	0.111111	
53	0.967786	0.342346	1	0.333333	-0.111111	0 	0 	0.111111	
159	0.905133	0.471351	0.888889	0.444444	0.111111	0 	0 	0.111111	
18	0.961226	0.485881	0.888889	0.444444	0.111111	0 	0 	0.111111	
187	0.963795	0.555956	1	0.555556	-0.111111	0 	0 	0.111111	
76	0.971504	0.563575	1	0.555556	-0.111111	0 	0 	0.111111	
127	0.919754	0.623091	1	0.555556	-0.111111	0 	0 	0.111111	
140	0.860581	0.651132	0.888889	0.666667	-0.111111	0 	0 	-0.111111	
191	0.821454	0.604694	0.888889	0.666667	-0.111111	0 	0 	-0.111111	
8	0.888638	0.575756	0.888889	0.666667	-0.111111	0 	0 	-0.111111	
82	0.792637	0.448371	0.777778	0.555556	0.111111	0 	0 	-0.111111	
31	0.83529	0.509267	0.777778	0.555556	0.111111	0 	0 	-0.111111	
165	0.813042	0.44354	0.888889	0.444444	-0.111111	0 	0 	-0.111111	
54	0.873579	0.387958	0.888889	0.444444	-0.111111	0 	0 	-0.111111	
114	0.858876	0.367092	0.888889	0.444444	-0.111111	0 	0 	-0.111111	
13	0.70888	0.406132	0.777778	0.333333	-0.111111	0 	0 	0.111111	
145	0.748514	0.375791	0.777778	0.333333	-0.111111	0 	0 	0.111111	
71	0.667156	0.515968	0.666667	0.444444	0.111111	0 	0 	0.111111	
173	0.723053	0.510399	0.666667	0.444444	0.111111	0 	0 	0.111111	
122	0.763985	0.548702	0.666667	0.444444	0.111111	0 	0 	0.111111	
36	0.776179	0.603912	0.777778	0.555556	-0.111111	0 	0 	0.111111	
96	0.716773	0.575576	0.777778	0.555556	-0.111111	0 	0 	0.111111	
125	0.644654	0.610975	0.666667	0.666667	-0.111111	0 	0 	-0.111111	
176	0.624625	0.631306	0.666667	0.666667	-0.111111	0 	0 	-0.111111	
65	0.582746	0.582199	0.666667	0.666667	-0.111111	0 	0 	-0.111111	
21	0.541502	0.613574	0.555556	0.555556	-0.111111	0 	0 	0.111111	
153	0.485597	0.563786	0.555556	0.555556	-0.111111	0 	0 	0.111111	
34	0.433994	0.61096	0.444444	0.666667	-0.111111	0 	0 	-0.111111	
85	0.34685	0.607274	0.444444	0.666667	-0.111111	0 	0 	-0.111111	
168	0.367878	0.554166	0.333333	0.555556	0.111111	0 	0 	-0.111111	
108	0.397508	0.476724	0.333333	0.555556	0.111111	0 	0 	-0.111111	
57	0.333603	0.555037	0.333333	0.555556	0.111111	0 	0 	-0.111111	
47	0.458847	0.501095	0.444444	0.444444	0.111111	0 	0 	0.111111	
107	0.528995	0.542012	0.444444	0.444444	0.111111	0 	0 	0.111111	
148	0.555925	0.462309	0.555556	0.555556	0.111111	0 	0 	-0.111111	
16	0.569575	0.496331	0.555556	0.555556	0.111111	0 	0 	-0.111111	
199	0.644286	0.450594	0.555556	0.555556	0.111111	0 	0 	-0.111111	
39	0.659727	0.374728	0.666667	0.444444	-0.111111	0 	0 	-0.111111	
90	0.609256	0.353341	0.666667	0.444444	-0.111111	0 	0 	-0.111111	
181	0.555457	0.364761	0.555556	0.333333	-0.111111	0 	0 	0.111111	
79	0.499213	0.436646	0.555556	0.333333	-0.111111	0 	0 	0.111111	
130	0.471848	0.399783	0.555556	0.333333	-0.111111	0 	0 	0.111111	
143	0.400762	0.397557	0.444444	0.444444	-0.111111	0 	0 	-0.111111	
194	0.380529	0.37668	0.444444	0.444444	-0.111111	0 	0 	-0.111111	
2	0.326057	0.335055	0.444444	0.444444	-0.111111	0 	0 	-0.111111	
28	0.331868	0.348903	0.333333	0.333333	-0.111111	0 	0 	0.111111	
88	0.249609	0.39797	0.333333	0.333333	-0.111111	0 	0 	0.111111	
5	0.278304	0.454953	0.222222	0.444444	0.111111	0 	0 	0.111111	
197	0.266987	0.485694	0.222222	0.444444	0.111111	0 	0 	0.111111	
137	0.277839	0.515703	0.222222	0.444444	0.111111	0 	0 	0.111111	
60	0.332946	0.643743	0.333333	0.555556	-0.111111	0 	0 	0.111111	
111	0.257969	0.591193	0.333333	0.555556	-0.111111	0 	0 	0.111111	
162	0.25309	0.654362	0.333333	0.555556	-0.111111	0 	0 	0.111111	
10	0.149768	0.624167	0.222222	0.666667	-0.111111	0 	0 	-0.111111	
151	0.109618	0.612418	0.222222	0.666667	-0.111111	0 	0 	-0.111111	
93	0.156388	0.457973	0.111111	0.555556	0.111111	0 	0 	-0.111111	
42	0.134782	0.535243	0.111111	0.555556	0.111111	0 	0 	-0.111111	
119	0.209053	0.443541	0.222222	0.444444	-0.111111	0 	0 	-0.111111	
179	0.165846	0.410474	0.222222	0.444444	-0.111111	0 	0 	-0.111111	
68	0.151965	0.348026	0.222222	0.444444	-0.111111	0 	0 	-0.111111	
24	0.0830386	0.413534	0.111111	0.333333	-0.111111	0 	0 	0.111111	
156	0.0354533	0.349223	0.111111	0.333333	-0.111111	0 	0 	0.111111	
184	0.102272	0.474784	0	0.444444	0.111111	0 	0 	0.111111	
133	0.0272956	0.521445	0	0.444444	0.111111	0 	0 	0.111111	
73	0.0551129	0.546828	0	0.444444	0.111111	0 	0 	0.111111	
101	0.0958918	0.639439	0.111111	0.555556	-0.111111	0 	0 	0.111111	
50	0.0123457	0.567901	0.111111	0.555556	-0.111111	0 	0 	0.111111	
144	0.0205419	0.689216	0	0.666667	0.111111	0 	0 	0.111111	
12	0.0395289	0.731411	0	0.666667	0.111111	0 	0 	0.111111	
167	0.166732	0.770763	0.111111	0.777778	0.111111	0 	0 	-0.111111	
116	0.180056	0.705277	0.111111	0.777778	0.111111	0 	0 	-0.111111	
56	0.212167	0.727742	0.111111	0.777778	0.111111	0 	0 	-0.111111	
52	0.222562	0.680684	0.222222	0.666667	0.111111	0 	0 	0.111111	
103	0.320449	0.762018	0.222222	0.666667	0.111111	0 	0 	0.111111	
20	0.277431	0.838673	0.333333	0.777778	-0.111111	0 	0 	0.111111	
161	0.260291	0.794315	0.333333	0.777778	-0.111111	0 	0 	0.111111	
30	0.207769	0.88207	0.222222	0.888889	-0.111111	0 	0 	-0.111111	
81	0.127414	0.835392	0.222222	0.888889	-0.111111	0 	0 	-0.111111	
121	0.0962381	0.803746	0.111111	0.777778	-0.111111	0 	0 	0.111111	
172	0.04877	0.849807	0.111111	0.777778	-0.111111	0 	0 	0.111111	
70	0.111086	0.778561	0.111111	0.777778	-0.111111	0 	0 	0.111111	
98	0.0132892	0.919797	0	0.888889	0.111111	0 	0 	0.111111	
38	0.0420364	0.955871	0	0.888889	0.111111	0 	0 	0.111111	
7	0.122596	0.998057	0.111111	1	0.111111	0 	0 	-0.111111	
190	0.152351	0.906289	0.111111	1	0.111111	0 	0 	-0.111111	
139	0.169369	0.99239	0.111111	1	0.111111	0 	0 	-0.111111	
186	0.328961	0.920206	0.222222	0.888889	0.111111	0 	0 	0.111111	
126	0.234669	0.91768	0.222222	0.888889	0.111111	0 	0 	0.111111	
75	0.270914	0.954609	0.222222	0.888889	0.111111	0 	0 	0.111111	
49	0.361356	0.893327	0.333333	1	0.111111	0 	0 	-0.111111	
100	0.417598	0.996431	0.333333	1	0.111111	0 	0 	-0.111111	
72	0.403282	0.87612	0.444444	0.888889	-0.111111	0 	0 	-0.111111	
132	0.382775	0.846798	0.444444	0.888889	-0.111111	0 	0 	-0.111111	
183	0.425602	0.801467	0.444444	0.888889	-0.111111	0 	0 	-0.111111	
158	0.38044	0.676924	0.333333	0.777778	0.111111	0 	0 	-0.111111	
26	0.348452	0.75071	0.333333	0.777778	0.111111	0 	0 	-0.111111	
67	0.45018	0.708629	0.444444	0.666667	0.111111	0 	0 	0.111111	
178	0.459833	0.694371	0.444444	0.666667	0.111111	0 	0 	0.111111	
118	0.541771	0.76905	0.444444	0.666667	0.111111	0 	0 	0.111111	
44	0.549646	0.853642	0.555556	0.777778	-0.111111	0 	0 	0.111111	
95	0.469029	0.794225	0.555556	0.777778	-0.111111	0 	0 	0.111111	
150	0.462336	0.923156	0.444444	0.888889	0.111111	0 	0 	0.111111	
9	0.470003	0.917012	0.444444	0.888889	0.111111	0 	0 	0.111111	
164	0.556681	0.973283	0.555556	1	0.111111	0 	0 	-0.111111	
113	0.55862	0.983043	0.555556	1	0.111111	0 	0 	-0.111111	
62	0.655861	0.945221	0.555556	1	0.111111	0 	0 	-0.111111	
136	0.639499	0.874017	0.666667	0.888889	-0.111111	0 	0 	-0.111111	
196	0.601189	0.828055	0.666667	0.888889	-0.111111	0 	0 	-0.111111	
4	0.558448	0.778089	0.666667	0.888889	-0.111111	0 	0 	-0.111111	
87	0.556112	0.713469	0.555556	0.777778	0.111111	0 	0 	-0.111111	
27	0.611284	0.747534	0.555556	0.777778	0.111111	0 	0 	-0.111111	
1	0.680604	0.690278	0.666667	0.666667	0.111111	0 	0 	0.111111	
193	0.677977	0.709371	0.666667	0.666667	0.111111	0 	0 	0.111111	
142	0.738441	0.747083	0.666667	0.666667	0.111111	0 	0 	0.111111	
129	0.793444	0.722096	0.777778	0.777778	0.111111	0 	0 	-0.111111	
78	0.805798	0.775071	0.777778	0.777778	0.111111	0 	0 	-0.111111	
180	0.882122	0.698054	0.777778	0.777778	0.111111	0 	0 	-0.111111	
92	0.903917	0.738766	0.888889	0.666667	0.111111	0 	0 	0.111111	
41	0.977193	0.718713	0.888889	0.666667	0.111111	0 	0 	0.111111	
198	0.972703	0.848583	1	0.777778	-0.111111	0 	0 	0.111111	
15	0.971334	0.793006	1	0.777778	-0.111111	0 	0 	0.111111	
147	0.890701	0.823976	1	0.777778	-0.111111	0 	0 	0.111111	
106	0.859836	0.867319	0.888889	0.888889	-0.111111	0 	0 	-0.111111	
46	0.790123	0.790123	0.888889	0.888889	-0.111111	0 	0 	-0.111111	
59	0.777684	0.867301	0.777778	0.777778	-0.111111	0 	0 	0.111111	
110	0.72048	0.796631	0.777778	0.777778	-0.111111	0 	0 	0.111111	
170	0.711592	0.886936	0.777778	0.777778	-0.111111	0 	0 	0.111111	
84	0.669052	0.930228	0.666667	0.888889	0.111111	0 	0 	0.111111	
33	0.726142	0.948279	0.666667	0.888889	0.111111	0 	0 	0.111111	
155	0.805697	0.979456	0.777778	1	0.111111	0 	0 	-0.111111	
23	0.833822	0.933969	0.777778	1	0.111111	0 	0 	-0.111111	
64	0.917739	0.891619	0.888889	0.888889	0.111111	0 	0 	0.111111	
175	0.918905	0.943613	0.888889	0.888889	0.111111	0 	0 	0.111111	
124	0.975896	0.986482	0.888889	0.888889	0.111111	0 	0 	0.111111	
