0	0.000108055	0.00690352	0	0	0.111111	0 	0 	0.111111	
192	0.0287125	0.0561551	0	0	0.111111	0 	0 	0.111111	
141	0.0886252	0.0853086	0	0	0.111111	0 	0 	0.111111	
131	0.146889	0.0679306	0.111111	0.111111	0.111111	0 	0 	-0.111111	
80	0.172501	0.0919616	0.111111	0.111111	0.111111	0 	0 	-0.111111	
182	0.216061	0.0378321	0.111111	0.111111	0.111111	0 	0 	-0.111111	
91	0.255272	0.020207	0.222222	0	0.111111	0 	0 	0.111111	
40	0.279238	0.0753632	0.222222	0	0.111111	0 	0 	0.111111	
200	0.319567	0.111932	0.333333	0.111111	-0.111111	0 	0 	0.111111	
17	0.279061	0.181198	0.333333	0.111111	-0.111111	0 	0 	0.111111	
149	0.221521	0.150291	0.333333	0.111111	-0.111111	0 	0 	0.111111	
105	0.211236	0.221601	0.222222	0.222222	-0.111111	0 	0 	-0.111111	
45	0.120074	0.127775	0.222222	0.222222	-0.111111	0 	0 	-0.111111	
58	0.108451	0.187678	0.111111	0.111111	-0.111111	0 	0 	0.111111	
109	0.0662925	0.150028	0.111111	0.111111	-0.111111	0 	0 	0.111111	
169	0.0334203	0.21658	0.111111	0.111111	-0.111111	0 	0 	0.111111	
86	0.0334489	0.261111	0	0.222222	0.111111	0 	0 	0.111111	
35	0.0287511	0.323999	0	0.222222	0.111111	0 	0 	0.111111	
214	0.125102	0.309487	0.111111	0.333333	0.111111	0 	0 	-0.111111	
154	0.168265	0.237971	0.111111	0.333333	0.111111	0 	0 	-0.111111	
22	0.187157	0.265217	0.111111	0.333333	0.111111	0 	0 	-0.111111	
63	0.242249	0.240554	0.222222	0.222222	0.111111	0 	0 	0.111111	
174	0.270306	0.287324	0.222222	0.222222	0.111111	0 	0 	0.111111	
123	0.325103	0.329218	0.222222	0.222222	0.111111	0 	0 	0.111111	
97	0.347894	0.229063	0.333333	0.333333	0.111111	0 	0 	-0.111111	
37	0.419753	0.271605	0.333333	0.333333	0.111111	0 	0 	-0.111111	
120	0.430164	0.18793	0.444444	0.222222	-0.111111	0 	0 	-0.111111	
171	0.401387	0.178088	0.444444	0.222222	-0.111111	0 	0 	-0.111111	
69	0.358012	0.142027	0.444444	0.222222	-0.111111	0 	0 	-0.111111	
146	0.392121	0.0994509	0.333333	0.111111	0.111111	0 	0 	-0.111111	
14	0.377352	0.0521707	0.333333	0.111111	0.111111	0 	0 	-0.111111	
206	0.417427	4.09354e-05	0.333333	0.111111	0.111111	0 	0 	-0.111111	
115	0.500331	0.0332488	0.444444	0	0.111111	0 	0 	0.111111	
55	0.52789	0.0596173	0.444444	0	0.111111	0 	0 	0.111111	
166	0.466069	0.110496	0.444444	0	0.111111	0 	0 	0.111111	
32	0.53134	0.160269	0.555556	0.111111	-0.111111	0 	0 	0.111111	
83	0.540381	0.209912	0.555556	0.111111	-0.111111	0 	0 	0.111111	
6	0.450105	0.264158	0.444444	0.222222	0.111111	0 	0 	0.111111	
189	0.484823	0.259777	0.444444	0.222222	0.111111	0 	0 	0.111111	
138	0.525095	0.305949	0.444444	0.222222	0.111111	0 	0 	0.111111	
128	0.569842	0.325092	0.555556	0.333333	0.111111	0 	0 	-0.111111	
77	0.62733	0.317385	0.555556	0.333333	0.111111	0 	0 	-0.111111	
188	0.658637	0.248692	0.555556	0.333333	0.111111	0 	0 	-0.111111	
211	0.573014	0.1906	0.666667	0.222222	-0.111111	0 	0 	-0.111111	
19	0.624089	0.157822	0.666667	0.222222	-0.111111	0 	0 	-0.111111	
160	0.666488	0.123976	0.666667	0.222222	-0.111111	0 	0 	-0.111111	
51	0.570162	0.0253202	0.555556	0.111111	0.111111	0 	0 	-0.111111	
102	0.569666	0.0955433	0.555556	0.111111	0.111111	0 	0 	-0.111111	
157	0.694557	0.0234577	0.666667	0	0.111111	0 	0 	0.111111	
25	0.736127	0.0564209	0.666667	0	0.111111	0 	0 	0.111111	
208	0.687757	0.0753507	0.666667	0	0.111111	0 	0 	0.111111	
66	0.792704	0.0395445	0.777778	0.111111	0.111111	0 	0 	-0.111111	
177	0.847812	0.0309908	0.777778	0.111111	0.111111	0 	0 	-0.111111	
117	0.875078	0.110017	0.777778	0.111111	0.111111	0 	0 	-0.111111	
89	0.913105	0.00482905	0.888889	0	0.111111	0 	0 	0.111111	
29	0.938272	0.0864198	0.888889	0	0.111111	0 	0 	0.111111	
135	0.998954	0.177417	1	0.111111	-0.111111	0 	0 	0.111111	
195	0.963009	0.125447	1	0.111111	-0.111111	0 	0 	0.111111	
3	0.899664	0.111236	1	0.111111	-0.111111	0 	0 	0.111111	
43	0.888113	0.221894	0.888889	0.222222	-0.111111	0 	0 	-0.111111	
94	0.831211	0.133379	0.888889	0.222222	-0.111111	0 	0 	-0.111111	
185	0.748753	0.137713	0.777778	0.111111	-0.111111	0 	0 	0.111111	
74	0.736978	0.194936	0.777778	0.111111	-0.111111	0 	0 	0.111111	
134	0.694389	0.169617	0.777778	0.111111	-0.111111	0 	0 	0.111111	
48	0.696737	0.278223	0.666667	0.222222	0.111111	0 	0 	0.111111	
99	0.757071	0.316258	0.666667	0.222222	0.111111	0 	0 	0.111111	
152	0.778196	0.265489	0.777778	0.333333	0.111111	0 	0 	-0.111111	
11	0.778222	0.258147	0.777778	0.333333	0.111111	0 	0 	-0.111111	
203	0.856912	0.22628	0.777778	0.333333	0.111111	0 	0 	-0.111111	
112	0.905306	0.229187	0.888889	0.222222	0.111111	0 	0 	0.111111	
61	0.988934	0.285099	0.888889	0.222222	0.111111	0 	0 	0.111111	
163	0.930987	0.319614	0.888889	0.222222	0.111111	0 	0 	0.111111	
104	0.998749	0.375013	1	0.333333	-0.111111	0 	0 	0.111111	
53	0.903309	0.347939	1	0.333333	-0.111111	0 	0 	0.111111	
159	0.889078	0.476269	0.888889	0.444444	0.111111	0 	0 	0.111111	
18	0.972791	0.485937	0.888889	0.444444	0.111111	0 	0 	0.111111	
210	0.889389	0.514267	0.888889	0.444444	0.111111	0 	0 	0.111111	
187	0.967866	0.561118	1	0.555556	-0.111111	0 	0 	0.111111	
76	0.984475	0.574875	1	0.555556	-0.111111	0 	0 	0.111111	
127	0.928959	0.627251	1	0.555556	-0.111111	0 	0 	0.111111	
140	0.857877	0.651648	0.888889	0.666667	-0.111111	0 	0 	-0.111111	
191	0.87893	0.568818	0.888889	0.666667	-0.111111	0 	0 	-0.111111	
8	0.777991	0.555625	0.888889	0.666667	-0.111111	0 	0 	-0.111111	
82	0.781056	0.467437	0.777778	0.555556	0.111111	0 	0 	-0.111111	
31	0.83189	0.525941	0.777778	0.555556	0.111111	0 	0 	-0.111111	
165	0.860922	0.34959	0.888889	0.444444	-0.111111	0 	0 	-0.111111	
54	0.87447	0.415122	0.888889	0.444444	-0.111111	0 	0 	-0.111111	
114	0.842328	0.356775	0.888889	0.444444	-0.111111	0 	0 	-0.111111	
205	0.776842	0.389656	0.777778	0.333333	-0.111111	0 	0 	0.111111	
13	0.720854	0.421768	0.777778	0.333333	-0.111111	0 	0 	0.111111	
145	0.672576	0.371576	0.777778	0.333333	-0.111111	0 	0 	0.111111	
71	0.667345	0.51418	0.666667	0.444444	0.111111	0 	0 	0.111111	
173	0.722456	0.502575	0.666667	0.444444	0.111111	0 	0 	0.111111	
122	0.771921	0.554854	0.666667	0.444444	0.111111	0 	0 	0.111111	
36	0.767769	0.653953	0.777778	0.555556	-0.111111	0 	0 	0.111111	
96	0.718735	0.560279	0.777778	0.555556	-0.111111	0 	0 	0.111111	
125	0.65892	0.598758	0.666667	0.666667	-0.111111	0 	0 	-0.111111	
176	0.623961	0.63303	0.666667	0.666667	-0.111111	0 	0 	-0.111111	
65	0.578669	0.579712	0.666667	0.666667	-0.111111	0 	0 	-0.111111	
21	0.526547	0.623882	0.555556	0.555556	-0.111111	0 	0 	0.111111	
153	0.478785	0.562518	0.555556	0.555556	-0.111111	0 	0 	0.111111	
213	0.452809	0.627977	0.555556	0.555556	-0.111111	0 	0 	0.111111	
34	0.378843	0.637021	0.444444	0.666667	-0.111111	0 	0 	-0.111111	
85	0.365334	0.610315	0.444444	0.666667	-0.111111	0 	0 	-0.111111	
168	0.336754	0.527211	0.333333	0.555556	0.111111	0 	0 	-0.111111	
108	0.397542	0.474421	0.333333	0.555556	0.111111	0 	0 	-0.111111	
57	0.432017	0.508055	0.333333	0.555556	0.111111	0 	0 	-0.111111	
47	0.445042	0.458926	0.444444	0.444444	0.111111	0 	0 	0.111111	
107	0.532767	0.536744	0.444444	0.444444	0.111111	0 	0 	0.111111	
148	0.556225	0.491229	0.555556	0.555556	0.111111	0 	0 	-0.111111	
16	0.611793	0.542761	0.555556	0.555556	0.111111	0 	0 	-0.111111	
199	0.583921	0.492254	0.555556	0.555556	0.111111	0 	0 	-0.111111	
39	0.666265	0.374233	0.666667	0.444444	-0.111111	0 	0 	-0.111111	
90	0.611777	0.351474	0.666667	0.444444	-0.111111	0 	0 	-0.111111	
181	0.554528	0.383735	0.555556	0.333333	-0.111111	0 	0 	0.111111	
79	0.513821	0.437994	0.555556	0.333333	-0.111111	0 	0 	0.111111	
130	0.472991	0.398904	0.555556	0.333333	-0.111111	0 	0 	0.111111	
143	0.414943	0.38609	0.444444	0.444444	-0.111111	0 	0 	-0.111111	
194	0.38131	0.377702	0.444444	0.444444	-0.111111	0 	0 	-0.111111	
2	0.335775	0.335468	0.444444	0.444444	-0.111111	0 	0 	-0.111111	
28	0.330123	0.361034	0.333333	0.333333	-0.111111	0 	0 	0.111111	
88	0.243344	0.39258	0.333333	0.333333	-0.111111	0 	0 	0.111111	
5	0.266268	0.461957	0.222222	0.444444	0.111111	0 	0 	0.111111	
197	0.27302	0.481297	0.222222	0.444444	0.111111	0 	0 	0.111111	
137	0.295162	0.529701	0.222222	0.444444	0.111111	0 	0 	0.111111	
60	0.318843	0.570102	0.333333	0.555556	-0.111111	0 	0 	0.111111	
111	0.263454	0.599448	0.333333	0.555556	-0.111111	0 	0 	0.111111	
162	0.254669	0.662189	0.333333	0.555556	-0.111111	0 	0 	0.111111	
10	0.188009	0.631151	0.222222	0.666667	-0.111111	0 	0 	-0.111111	
151	0.114561	0.607891	0.222222	0.666667	-0.111111	0 	0 	-0.111111	
202	0.207751	0.558668	0.222222	0.666667	-0.111111	0 	0 	-0.111111	
93	0.162805	0.46591	0.111111	0.555556	0.111111	0 	0 	-0.111111	
42	0.125068	0.539884	0.111111	0.555556	0.111111	0 	0 	-0.111111	
119	0.200267	0.443003	0.222222	0.444444	-0.111111	0 	0 	-0.111111	
179	0.180173	0.385954	0.222222	0.444444	-0.111111	0 	0 	-0.111111	
68	0.133626	0.353464	0.222222	0.444444	-0.111111	0 	0 	-0.111111	
24	0.0787928	0.347939	0.111111	0.333333	-0.111111	0 	0 	0.111111	
156	0.0907319	0.406532	0.111111	0.333333	-0.111111	0 	0 	0.111111	
207	0.0128309	0.422354	0.111111	0.333333	-0.111111	0 	0 	0.111111	
184	0.111131	0.477119	0	0.444444	0.111111	0 	0 	0.111111	
133	0.0285175	0.532375	0	0.444444	0.111111	0 	0 	0.111111	
73	0.0619444	0.547289	0	0.444444	0.111111	0 	0 	0.111111	
101	0.110952	0.652902	0.111111	0.555556	-0.111111	0 	0 	0.111111	
50	0.0121463	0.567299	0.111111	0.555556	-0.111111	0 	0 	0.111111	
204	0.0681557	0.675996	0	0.666667	0.111111	0 	0 	0.111111	
144	0.0317198	0.702568	0	0.666667	0.111111	0 	0 	0.111111	
12	0.0251141	0.75305	0	0.666667	0.111111	0 	0 	0.111111	
167	0.156445	0.768593	0.111111	0.777778	0.111111	0 	0 	-0.111111	
116	0.156931	0.709745	0.111111	0.777778	0.111111	0 	0 	-0.111111	
56	0.213634	0.729009	0.111111	0.777778	0.111111	0 	0 	-0.111111	
52	0.225957	0.708508	0.222222	0.666667	0.111111	0 	0 	0.111111	
103	0.310712	0.762939	0.222222	0.666667	0.111111	0 	0 	0.111111	
20	0.318539	0.821163	0.333333	0.777778	-0.111111	0 	0 	0.111111	
161	0.257214	0.783435	0.333333	0.777778	-0.111111	0 	0 	0.111111	
212	0.230453	0.855967	0.333333	0.777778	-0.111111	0 	0 	0.111111	
30	0.195352	0.865546	0.222222	0.888889	-0.111111	0 	0 	-0.111111	
81	0.131366	0.836222	0.222222	0.888889	-0.111111	0 	0 	-0.111111	
121	0.106367	0.874516	0.111111	0.777778	-0.111111	0 	0 	0.111111	
172	0.0589033	0.850222	0.111111	0.777778	-0.111111	0 	0 	0.111111	
70	0.0928086	0.797322	0.111111	0.777778	-0.111111	0 	0 	0.111111	
98	0.0341909	0.916816	0	0.888889	0.111111	0 	0 	0.111111	
38	0.0227226	0.942691	0	0.888889	0.111111	0 	0 	0.111111	
7	0.113606	0.986506	0.111111	1	0.111111	0 	0 	-0.111111	
190	0.153596	0.923393	0.111111	1	0.111111	0 	0 	-0.111111	
139	0.198322	0.977817	0.111111	1	0.111111	0 	0 	-0.111111	
186	0.331761	0.921437	0.222222	0.888889	0.111111	0 	0 	0.111111	
126	0.236202	0.94136	0.222222	0.888889	0.111111	0 	0 	0.111111	
75	0.27976	0.986539	0.222222	0.888889	0.111111	0 	0 	0.111111	
49	0.352564	0.890608	0.333333	1	0.111111	0 	0 	-0.111111	
100	0.418311	0.99183	0.333333	1	0.111111	0 	0 	-0.111111	
72	0.4027	0.851897	0.444444	0.888889	-0.111111	0 	0 	-0.111111	
132	0.365317	0.847193	0.444444	0.888889	-0.111111	0 	0 	-0.111111	
183	0.413746	0.828513	0.444444	0.888889	-0.111111	0 	0 	-0.111111	
209	0.361403	0.744249	0.333333	0.777778	0.111111	0 	0 	-0.111111	
158	0.363095	0.667273	0.333333	0.777778	0.111111	0 	0 	-0.111111	
26	0.412723	0.699627	0.333333	0.777778	0.111111	0 	0 	-0.111111	
67	0.460491	0.703203	0.444444	0.666667	0.111111	0 	0 	0.111111	
178	0.511246	0.728303	0.444444	0.666667	0.111111	0 	0 	0.111111	
118	0.551504	0.770615	0.444444	0.666667	0.111111	0 	0 	0.111111	
44	0.555237	0.88463	0.555556	0.777778	-0.111111	0 	0 	0.111111	
95	0.496159	0.789948	0.555556	0.777778	-0.111111	0 	0 	0.111111	
201	0.499476	0.905575	0.444444	0.888889	0.111111	0 	0 	0.111111	
150	0.500394	0.956854	0.444444	0.888889	0.111111	0 	0 	0.111111	
9	0.445231	0.889112	0.444444	0.888889	0.111111	0 	0 	0.111111	
164	0.55809	0.971769	0.555556	1	0.111111	0 	0 	-0.111111	
113	0.570327	0.986138	0.555556	1	0.111111	0 	0 	-0.111111	
62	0.656037	0.942055	0.555556	1	0.111111	0 	0 	-0.111111	
136	0.637637	0.873861	0.666667	0.888889	-0.111111	0 	0 	-0.111111	
196	0.602206	0.824092	0.666667	0.888889	-0.111111	0 	0 	-0.111111	
4	0.556849	0.777918	0.666667	0.888889	-0.111111	0 	0 	-0.111111	
87	0.584808	0.681242	0.555556	0.777778	0.111111	0 	0 	-0.111111	
27	0.607729	0.754785	0.555556	0.777778	0.111111	0 	0 	-0.111111	
1	0.68151	0.694925	0.666667	0.666667	0.111111	0 	0 	0.111111	
193	0.696132	0.701272	0.666667	0.666667	0.111111	0 	0 	0.111111	
142	0.747687	0.746526	0.666667	0.666667	0.111111	0 	0 	0.111111	
129	0.808116	0.731158	0.777778	0.777778	0.111111	0 	0 	-0.111111	
78	0.80563	0.738764	0.777778	0.777778	0.111111	0 	0 	-0.111111	
180	0.890849	0.69656	0.777778	0.777778	0.111111	0 	0 	-0.111111	
92	0.891492	0.68087	0.888889	0.666667	0.111111	0 	0 	0.111111	
41	0.985588	0.723407	0.888889	0.666667	0.111111	0 	0 	0.111111	
198	0.993064	0.852214	1	0.777778	-0.111111	0 	0 	0.111111	
15	0.928781	0.845085	1	0.777778	-0.111111	0 	0 	0.111111	
147	0.942998	0.780087	1	0.777778	-0.111111	0 	0 	0.111111	
106	0.860396	0.859536	0.888889	0.888889	-0.111111	0 	0 	-0.111111	
46	0.885699	0.788248	0.888889	0.888889	-0.111111	0 	0 	-0.111111	
59	0.760607	0.821646	0.777778	0.777778	-0.111111	0 	0 	0.111111	
110	0.720724	0.808624	0.777778	0.777778	-0.111111	0 	0 	0.111111	
170	0.749116	0.800499	0.777778	0.777778	-0.111111	0 	0 	0.111111	
216	0.750658	0.897291	0.666667	0.888889	0.111111	0 	0 	0.111111	
84	0.681749	0.942929	0.666667	0.888889	0.111111	0 	0 	0.111111	
33	0.697137	0.889122	0.666667	0.888889	0.111111	0 	0 	0.111111	
215	0.806738	0.944455	0.777778	1	0.111111	0 	0 	-0.111111	
155	0.817286	0.985026	0.777778	1	0.111111	0 	0 	-0.111111	
23	0.848783	0.917046	0.777778	1	0.111111	0 	0 	-0.111111	
64	0.90304	0.920971	0.888889	0.888889	0.111111	0 	0 	0.111111	
175	0.904156	0.925859	0.888889	0.888889	0.111111	0 	0 	0.111111	
124	0.98689	0.996559	0.888889	0.888889	0.111111	0 	0 	0.111111	
