0	0.000343627	0.0139339	0	0	0.111111	0 	0 	0.111111	
141	0.0696466	0.0676276	0	0	0.111111	0 	0 	0.111111	
131	0.12632	0.0560734	0.111111	0.111111	0.111111	0 	0 	-0.111111	
80	0.183245	0.0934963	0.111111	0.111111	0.111111	0 	0 	-0.111111	
182	0.226062	0.0275068	0.111111	0.111111	0.111111	0 	0 	-0.111111	
91	0.265308	0.0194794	0.222222	0	0.111111	0 	0 	0.111111	
40	0.282657	0.0800951	0.222222	0	0.111111	0 	0 	0.111111	
17	0.318844	0.189403	0.333333	0.111111	-0.111111	0 	0 	0.111111	
149	0.224643	0.154904	0.333333	0.111111	-0.111111	0 	0 	0.111111	
105	0.221791	0.221426	0.222222	0.222222	-0.111111	0 	0 	-0.111111	
45	0.126821	0.125956	0.222222	0.222222	-0.111111	0 	0 	-0.111111	
58	0.0935047	0.157444	0.111111	0.111111	-0.111111	0 	0 	0.111111	
109	0.0970907	0.183307	0.111111	0.111111	-0.111111	0 	0 	0.111111	
169	0.0312513	0.214613	0.111111	0.111111	-0.111111	0 	0 	0.111111	
86	0.0292846	0.261013	0	0.222222	0.111111	0 	0 	0.111111	
35	0.0421027	0.309513	0	0.222222	0.111111	0 	0 	0.111111	
154	0.178979	0.236642	0.111111	0.333333	0.111111	0 	0 	-0.111111	
22	0.132291	0.305067	0.111111	0.333333	0.111111	0 	0 	-0.111111	
63	0.24545	0.264141	0.222222	0.222222	0.111111	0 	0 	0.111111	
174	0.274064	0.293413	0.222222	0.222222	0.111111	0 	0 	0.111111	
123	0.308612	0.330432	0.222222	0.222222	0.111111	0 	0 	0.111111	
97	0.334058	0.246621	0.333333	0.333333	0.111111	0 	0 	-0.111111	
37	0.428373	0.287414	0.333333	0.333333	0.111111	0 	0 	-0.111111	
120	0.44422	0.204255	0.444444	0.222222	-0.111111	0 	0 	-0.111111	
171	0.424115	0.145203	0.444444	0.222222	-0.111111	0 	0 	-0.111111	
69	0.352081	0.121532	0.444444	0.222222	-0.111111	0 	0 	-0.111111	
146	0.349743	0.0712277	0.333333	0.111111	0.111111	0 	0 	-0.111111	
14	0.36123	0.100585	0.333333	0.111111	0.111111	0 	0 	-0.111111	
115	0.506129	0.0458592	0.444444	0	0.111111	0 	0 	0.111111	
55	0.530529	0.0644357	0.444444	0	0.111111	0 	0 	0.111111	
166	0.460217	0.0467695	0.444444	0	0.111111	0 	0 	0.111111	
32	0.551382	0.168512	0.555556	0.111111	-0.111111	0 	0 	0.111111	
83	0.471699	0.187689	0.555556	0.111111	-0.111111	0 	0 	0.111111	
6	0.452418	0.26512	0.444444	0.222222	0.111111	0 	0 	0.111111	
138	0.530559	0.292797	0.444444	0.222222	0.111111	0 	0 	0.111111	
128	0.571017	0.235662	0.555556	0.333333	0.111111	0 	0 	-0.111111	
77	0.611627	0.319445	0.555556	0.333333	0.111111	0 	0 	-0.111111	
188	0.663826	0.252363	0.555556	0.333333	0.111111	0 	0 	-0.111111	
19	0.624977	0.161583	0.666667	0.222222	-0.111111	0 	0 	-0.111111	
160	0.600237	0.117063	0.666667	0.222222	-0.111111	0 	0 	-0.111111	
51	0.555913	0.000457485	0.555556	0.111111	0.111111	0 	0 	-0.111111	
102	0.655622	0.092135	0.555556	0.111111	0.111111	0 	0 	-0.111111	
157	0.694852	0.0276136	0.666667	0	0.111111	0 	0 	0.111111	
25	0.731415	0.0369691	0.666667	0	0.111111	0 	0 	0.111111	
66	0.779385	0.0994716	0.777778	0.111111	0.111111	0 	0 	-0.111111	
177	0.862085	0.0688431	0.777778	0.111111	0.111111	0 	0 	-0.111111	
117	0.87426	0.106647	0.777778	0.111111	0.111111	0 	0 	-0.111111	
89	0.901408	0.0396153	0.888889	0	0.111111	0 	0 	0.111111	
29	0.903368	0.0166847	0.888889	0	0.111111	0 	0 	0.111111	
135	0.999833	0.193146	1	0.111111	-0.111111	0 	0 	0.111111	
3	0.984367	0.122347	1	0.111111	-0.111111	0 	0 	0.111111	
43	0.888551	0.138579	0.888889	0.222222	-0.111111	0 	0 	-0.111111	
94	0.860779	0.215677	0.888889	0.222222	-0.111111	0 	0 	-0.111111	
185	0.76126	0.139011	0.777778	0.111111	-0.111111	0 	0 	0.111111	
74	0.740427	0.206872	0.777778	0.111111	-0.111111	0 	0 	0.111111	
134	0.679423	0.154052	0.777778	0.111111	-0.111111	0 	0 	0.111111	
48	0.69628	0.254244	0.666667	0.222222	0.111111	0 	0 	0.111111	
99	0.750781	0.31866	0.666667	0.222222	0.111111	0 	0 	0.111111	
152	0.778539	0.237513	0.777778	0.333333	0.111111	0 	0 	-0.111111	
11	0.807406	0.276821	0.777778	0.333333	0.111111	0 	0 	-0.111111	
112	0.916789	0.227068	0.888889	0.222222	0.111111	0 	0 	0.111111	
61	0.985139	0.291169	0.888889	0.222222	0.111111	0 	0 	0.111111	
163	0.916844	0.290304	0.888889	0.222222	0.111111	0 	0 	0.111111	
104	0.986095	0.437923	1	0.333333	-0.111111	0 	0 	0.111111	
53	0.904638	0.350486	1	0.333333	-0.111111	0 	0 	0.111111	
159	0.889054	0.491207	0.888889	0.444444	0.111111	0 	0 	0.111111	
18	0.920962	0.462954	0.888889	0.444444	0.111111	0 	0 	0.111111	
187	0.969249	0.581626	1	0.555556	-0.111111	0 	0 	0.111111	
76	0.983217	0.557858	1	0.555556	-0.111111	0 	0 	0.111111	
127	0.930988	0.633157	1	0.555556	-0.111111	0 	0 	0.111111	
140	0.888473	0.580163	0.888889	0.666667	-0.111111	0 	0 	-0.111111	
8	0.87479	0.656866	0.888889	0.666667	-0.111111	0 	0 	-0.111111	
82	0.792098	0.463405	0.777778	0.555556	0.111111	0 	0 	-0.111111	
31	0.823124	0.514859	0.777778	0.555556	0.111111	0 	0 	-0.111111	
165	0.789965	0.429055	0.888889	0.444444	-0.111111	0 	0 	-0.111111	
54	0.860581	0.391318	0.888889	0.444444	-0.111111	0 	0 	-0.111111	
114	0.861088	0.359658	0.888889	0.444444	-0.111111	0 	0 	-0.111111	
13	0.718391	0.392218	0.777778	0.333333	-0.111111	0 	0 	0.111111	
145	0.685796	0.376009	0.777778	0.333333	-0.111111	0 	0 	0.111111	
71	0.674593	0.526019	0.666667	0.444444	0.111111	0 	0 	0.111111	
173	0.722803	0.5065	0.666667	0.444444	0.111111	0 	0 	0.111111	
122	0.772089	0.555069	0.666667	0.444444	0.111111	0 	0 	0.111111	
36	0.762792	0.596254	0.777778	0.555556	-0.111111	0 	0 	0.111111	
96	0.758844	0.653327	0.777778	0.555556	-0.111111	0 	0 	0.111111	
125	0.651834	0.653528	0.666667	0.666667	-0.111111	0 	0 	-0.111111	
176	0.64495	0.596826	0.666667	0.666667	-0.111111	0 	0 	-0.111111	
65	0.581932	0.584119	0.666667	0.666667	-0.111111	0 	0 	-0.111111	
21	0.527775	0.64612	0.555556	0.555556	-0.111111	0 	0 	0.111111	
153	0.483201	0.566988	0.555556	0.555556	-0.111111	0 	0 	0.111111	
34	0.428941	0.612905	0.444444	0.666667	-0.111111	0 	0 	-0.111111	
85	0.346583	0.609777	0.444444	0.666667	-0.111111	0 	0 	-0.111111	
168	0.353674	0.481777	0.333333	0.555556	0.111111	0 	0 	-0.111111	
108	0.396714	0.482605	0.333333	0.555556	0.111111	0 	0 	-0.111111	
57	0.441918	0.512079	0.333333	0.555556	0.111111	0 	0 	-0.111111	
47	0.444518	0.444573	0.444444	0.444444	0.111111	0 	0 	0.111111	
107	0.530273	0.534731	0.444444	0.444444	0.111111	0 	0 	0.111111	
148	0.564851	0.47188	0.555556	0.555556	0.111111	0 	0 	-0.111111	
16	0.599685	0.529828	0.555556	0.555556	0.111111	0 	0 	-0.111111	
39	0.652653	0.439206	0.666667	0.444444	-0.111111	0 	0 	-0.111111	
90	0.609934	0.357854	0.666667	0.444444	-0.111111	0 	0 	-0.111111	
181	0.526821	0.343913	0.555556	0.333333	-0.111111	0 	0 	0.111111	
79	0.51333	0.428244	0.555556	0.333333	-0.111111	0 	0 	0.111111	
130	0.548596	0.417314	0.555556	0.333333	-0.111111	0 	0 	0.111111	
143	0.430386	0.377326	0.444444	0.444444	-0.111111	0 	0 	-0.111111	
2	0.348497	0.345756	0.444444	0.444444	-0.111111	0 	0 	-0.111111	
28	0.333004	0.394366	0.333333	0.333333	-0.111111	0 	0 	0.111111	
88	0.247005	0.377062	0.333333	0.333333	-0.111111	0 	0 	0.111111	
5	0.265099	0.482653	0.222222	0.444444	0.111111	0 	0 	0.111111	
137	0.290547	0.523461	0.222222	0.444444	0.111111	0 	0 	0.111111	
60	0.328348	0.611809	0.333333	0.555556	-0.111111	0 	0 	0.111111	
111	0.281302	0.586187	0.333333	0.555556	-0.111111	0 	0 	0.111111	
162	0.248416	0.664616	0.333333	0.555556	-0.111111	0 	0 	0.111111	
10	0.137572	0.61716	0.222222	0.666667	-0.111111	0 	0 	-0.111111	
151	0.193388	0.610517	0.222222	0.666667	-0.111111	0 	0 	-0.111111	
93	0.127338	0.527534	0.111111	0.555556	0.111111	0 	0 	-0.111111	
42	0.196987	0.494888	0.111111	0.555556	0.111111	0 	0 	-0.111111	
119	0.207684	0.441916	0.222222	0.444444	-0.111111	0 	0 	-0.111111	
179	0.172238	0.403347	0.222222	0.444444	-0.111111	0 	0 	-0.111111	
68	0.13123	0.354425	0.222222	0.444444	-0.111111	0 	0 	-0.111111	
24	0.0911407	0.423402	0.111111	0.333333	-0.111111	0 	0 	0.111111	
156	0.0377617	0.342757	0.111111	0.333333	-0.111111	0 	0 	0.111111	
184	0.11092	0.476477	0	0.444444	0.111111	0 	0 	0.111111	
133	0.0219241	0.488704	0	0.444444	0.111111	0 	0 	0.111111	
73	0.0613816	0.542569	0	0.444444	0.111111	0 	0 	0.111111	
101	0.107046	0.634165	0.111111	0.555556	-0.111111	0 	0 	0.111111	
50	0.0122431	0.569848	0.111111	0.555556	-0.111111	0 	0 	0.111111	
144	0.0286457	0.692788	0	0.666667	0.111111	0 	0 	0.111111	
12	0.0354807	0.73123	0	0.666667	0.111111	0 	0 	0.111111	
167	0.131594	0.770964	0.111111	0.777778	0.111111	0 	0 	-0.111111	
116	0.181248	0.726372	0.111111	0.777778	0.111111	0 	0 	-0.111111	
56	0.1242	0.729826	0.111111	0.777778	0.111111	0 	0 	-0.111111	
52	0.22387	0.666828	0.222222	0.666667	0.111111	0 	0 	0.111111	
103	0.302458	0.761029	0.222222	0.666667	0.111111	0 	0 	0.111111	
20	0.290099	0.808913	0.333333	0.777778	-0.111111	0 	0 	0.111111	
161	0.262056	0.782017	0.333333	0.777778	-0.111111	0 	0 	0.111111	
30	0.15948	0.863092	0.222222	0.888889	-0.111111	0 	0 	-0.111111	
81	0.205101	0.842824	0.222222	0.888889	-0.111111	0 	0 	-0.111111	
121	0.106297	0.86139	0.111111	0.777778	-0.111111	0 	0 	0.111111	
172	0.0678055	0.864959	0.111111	0.777778	-0.111111	0 	0 	0.111111	
70	0.0229925	0.803254	0.111111	0.777778	-0.111111	0 	0 	0.111111	
98	0.0154187	0.95737	0	0.888889	0.111111	0 	0 	0.111111	
38	0.0851614	0.938559	0	0.888889	0.111111	0 	0 	0.111111	
7	0.158087	0.946379	0.111111	1	0.111111	0 	0 	-0.111111	
139	0.19568	0.979657	0.111111	1	0.111111	0 	0 	-0.111111	
186	0.330113	0.917638	0.222222	0.888889	0.111111	0 	0 	0.111111	
126	0.236483	0.907025	0.222222	0.888889	0.111111	0 	0 	0.111111	
75	0.278152	0.985801	0.222222	0.888889	0.111111	0 	0 	0.111111	
49	0.333355	0.896756	0.333333	1	0.111111	0 	0 	-0.111111	
100	0.416956	0.992465	0.333333	1	0.111111	0 	0 	-0.111111	
72	0.428465	0.869002	0.444444	0.888889	-0.111111	0 	0 	-0.111111	
132	0.374915	0.842018	0.444444	0.888889	-0.111111	0 	0 	-0.111111	
183	0.444423	0.79999	0.444444	0.888889	-0.111111	0 	0 	-0.111111	
158	0.376809	0.668148	0.333333	0.777778	0.111111	0 	0 	-0.111111	
26	0.363264	0.743858	0.333333	0.777778	0.111111	0 	0 	-0.111111	
67	0.444456	0.692935	0.444444	0.666667	0.111111	0 	0 	0.111111	
178	0.458356	0.707864	0.444444	0.666667	0.111111	0 	0 	0.111111	
118	0.543404	0.773434	0.444444	0.666667	0.111111	0 	0 	0.111111	
44	0.555463	0.877296	0.555556	0.777778	-0.111111	0 	0 	0.111111	
95	0.497355	0.799708	0.555556	0.777778	-0.111111	0 	0 	0.111111	
150	0.45955	0.918077	0.444444	0.888889	0.111111	0 	0 	0.111111	
9	0.49415	0.95982	0.444444	0.888889	0.111111	0 	0 	0.111111	
164	0.583268	0.997074	0.555556	1	0.111111	0 	0 	-0.111111	
113	0.568785	0.916526	0.555556	1	0.111111	0 	0 	-0.111111	
62	0.653178	0.927633	0.555556	1	0.111111	0 	0 	-0.111111	
136	0.652314	0.807513	0.666667	0.888889	-0.111111	0 	0 	-0.111111	
4	0.559016	0.778929	0.666667	0.888889	-0.111111	0 	0 	-0.111111	
87	0.569897	0.708313	0.555556	0.777778	0.111111	0 	0 	-0.111111	
27	0.616977	0.750403	0.555556	0.777778	0.111111	0 	0 	-0.111111	
1	0.681418	0.691738	0.666667	0.666667	0.111111	0 	0 	0.111111	
142	0.737027	0.741392	0.666667	0.666667	0.111111	0 	0 	0.111111	
129	0.805881	0.738948	0.777778	0.777778	0.111111	0 	0 	-0.111111	
78	0.77824	0.708158	0.777778	0.777778	0.111111	0 	0 	-0.111111	
180	0.890722	0.696253	0.777778	0.777778	0.111111	0 	0 	-0.111111	
92	0.889215	0.738391	0.888889	0.666667	0.111111	0 	0 	0.111111	
41	0.973163	0.724905	0.888889	0.666667	0.111111	0 	0 	0.111111	
15	0.932427	0.848596	1	0.777778	-0.111111	0 	0 	0.111111	
147	0.990036	0.819902	1	0.777778	-0.111111	0 	0 	0.111111	
106	0.859793	0.888133	0.888889	0.888889	-0.111111	0 	0 	-0.111111	
46	0.865221	0.83561	0.888889	0.888889	-0.111111	0 	0 	-0.111111	
59	0.758714	0.819526	0.777778	0.777778	-0.111111	0 	0 	0.111111	
110	0.750802	0.814587	0.777778	0.777778	-0.111111	0 	0 	0.111111	
170	0.71297	0.886423	0.777778	0.777778	-0.111111	0 	0 	0.111111	
84	0.682427	0.915966	0.666667	0.888889	0.111111	0 	0 	0.111111	
33	0.680791	0.933553	0.666667	0.888889	0.111111	0 	0 	0.111111	
155	0.805581	0.971734	0.777778	1	0.111111	0 	0 	-0.111111	
23	0.832243	0.931322	0.777778	1	0.111111	0 	0 	-0.111111	
64	0.902892	0.921922	0.888889	0.888889	0.111111	0 	0 	0.111111	
175	0.901079	0.925367	0.888889	0.888889	0.111111	0 	0 	0.111111	
124	0.984942	0.98763	0.888889	0.888889	0.111111	0 	0 	0.111111	
