0	0.00146706	0.0140149	0	0	0.111111	0 	0 	0.111111	
141	0.0682252	0.0760414	0	0	0.111111	0 	0 	0.111111	
131	0.133084	0.0685159	0.111111	0.111111	0.111111	0 	0 	-0.111111	
80	0.180645	0.0952024	0.111111	0.111111	0.111111	0 	0 	-0.111111	
182	0.216753	0.0361649	0.111111	0.111111	0.111111	0 	0 	-0.111111	
91	0.25235	0.0227433	0.222222	0	0.111111	0 	0 	0.111111	
40	0.283938	0.0778102	0.222222	0	0.111111	0 	0 	0.111111	
17	0.25543	0.172155	0.333333	0.111111	-0.111111	0 	0 	0.111111	
149	0.316988	0.18822	0.333333	0.111111	-0.111111	0 	0 	0.111111	
105	0.218344	0.204484	0.222222	0.222222	-0.111111	0 	0 	-0.111111	
45	0.126996	0.129804	0.222222	0.222222	-0.111111	0 	0 	-0.111111	
58	0.108899	0.181603	0.111111	0.111111	-0.111111	0 	0 	0.111111	
109	0.0597777	0.122084	0.111111	0.111111	-0.111111	0 	0 	0.111111	
169	0.0312639	0.213047	0.111111	0.111111	-0.111111	0 	0 	0.111111	
86	0.0138342	0.308604	0	0.222222	0.111111	0 	0 	0.111111	
35	0.0228863	0.307664	0	0.222222	0.111111	0 	0 	0.111111	
154	0.128499	0.277664	0.111111	0.333333	0.111111	0 	0 	-0.111111	
22	0.186166	0.249917	0.111111	0.333333	0.111111	0 	0 	-0.111111	
63	0.241036	0.254218	0.222222	0.222222	0.111111	0 	0 	0.111111	
174	0.22318	0.293507	0.222222	0.222222	0.111111	0 	0 	0.111111	
123	0.321278	0.333082	0.222222	0.222222	0.111111	0 	0 	0.111111	
97	0.346518	0.242425	0.333333	0.333333	0.111111	0 	0 	-0.111111	
37	0.424344	0.29995	0.333333	0.333333	0.111111	0 	0 	-0.111111	
120	0.427936	0.174064	0.444444	0.222222	-0.111111	0 	0 	-0.111111	
171	0.40835	0.176807	0.444444	0.222222	-0.111111	0 	0 	-0.111111	
69	0.360048	0.135129	0.444444	0.222222	-0.111111	0 	0 	-0.111111	
146	0.354537	0.0294151	0.333333	0.111111	0.111111	0 	0 	-0.111111	
14	0.375343	0.0865858	0.333333	0.111111	0.111111	0 	0 	-0.111111	
115	0.512414	0.0304855	0.444444	0	0.111111	0 	0 	0.111111	
55	0.472464	0.0617659	0.444444	0	0.111111	0 	0 	0.111111	
166	0.477117	0.108522	0.444444	0	0.111111	0 	0 	0.111111	
32	0.54162	0.184879	0.555556	0.111111	-0.111111	0 	0 	0.111111	
83	0.554497	0.174775	0.555556	0.111111	-0.111111	0 	0 	0.111111	
6	0.457522	0.24564	0.444444	0.222222	0.111111	0 	0 	0.111111	
138	0.515775	0.293922	0.444444	0.222222	0.111111	0 	0 	0.111111	
128	0.570884	0.246653	0.555556	0.333333	0.111111	0 	0 	-0.111111	
77	0.61117	0.30814	0.555556	0.333333	0.111111	0 	0 	-0.111111	
19	0.665984	0.151478	0.666667	0.222222	-0.111111	0 	0 	-0.111111	
160	0.604137	0.116035	0.666667	0.222222	-0.111111	0 	0 	-0.111111	
51	0.564091	0.0135615	0.555556	0.111111	0.111111	0 	0 	-0.111111	
102	0.640403	0.0925552	0.555556	0.111111	0.111111	0 	0 	-0.111111	
157	0.696568	0.00300816	0.666667	0	0.111111	0 	0 	0.111111	
25	0.711716	0.0632918	0.666667	0	0.111111	0 	0 	0.111111	
66	0.817518	0.00790754	0.777778	0.111111	0.111111	0 	0 	-0.111111	
177	0.789855	0.0964729	0.777778	0.111111	0.111111	0 	0 	-0.111111	
117	0.794474	0.105605	0.777778	0.111111	0.111111	0 	0 	-0.111111	
89	0.917485	0.00303277	0.888889	0	0.111111	0 	0 	0.111111	
29	0.972721	0.0791119	0.888889	0	0.111111	0 	0 	0.111111	
135	0.970048	0.122855	1	0.111111	-0.111111	0 	0 	0.111111	
3	0.888889	0.111111	1	0.111111	-0.111111	0 	0 	0.111111	
43	0.888091	0.150018	0.888889	0.222222	-0.111111	0 	0 	-0.111111	
94	0.888707	0.179597	0.888889	0.222222	-0.111111	0 	0 	-0.111111	
185	0.763545	0.194665	0.777778	0.111111	-0.111111	0 	0 	0.111111	
74	0.724362	0.208323	0.777778	0.111111	-0.111111	0 	0 	0.111111	
134	0.694388	0.184163	0.777778	0.111111	-0.111111	0 	0 	0.111111	
48	0.682547	0.260662	0.666667	0.222222	0.111111	0 	0 	0.111111	
99	0.748918	0.317976	0.666667	0.222222	0.111111	0 	0 	0.111111	
152	0.808239	0.266092	0.777778	0.333333	0.111111	0 	0 	-0.111111	
11	0.820233	0.289206	0.777778	0.333333	0.111111	0 	0 	-0.111111	
112	0.944454	0.273647	0.888889	0.222222	0.111111	0 	0 	0.111111	
61	0.987929	0.269056	0.888889	0.222222	0.111111	0 	0 	0.111111	
163	0.90367	0.246163	0.888889	0.222222	0.111111	0 	0 	0.111111	
104	0.988118	0.403948	1	0.333333	-0.111111	0 	0 	0.111111	
53	0.904152	0.340908	1	0.333333	-0.111111	0 	0 	0.111111	
159	0.918819	0.459048	0.888889	0.444444	0.111111	0 	0 	0.111111	
18	0.911206	0.527823	0.888889	0.444444	0.111111	0 	0 	0.111111	
187	0.980527	0.555907	1	0.555556	-0.111111	0 	0 	0.111111	
76	0.971514	0.586238	1	0.555556	-0.111111	0 	0 	0.111111	
127	0.936355	0.614982	1	0.555556	-0.111111	0 	0 	0.111111	
140	0.846808	0.634354	0.888889	0.666667	-0.111111	0 	0 	-0.111111	
8	0.786876	0.55839	0.888889	0.666667	-0.111111	0 	0 	-0.111111	
82	0.79615	0.468385	0.777778	0.555556	0.111111	0 	0 	-0.111111	
31	0.825975	0.520799	0.777778	0.555556	0.111111	0 	0 	-0.111111	
165	0.860159	0.443718	0.888889	0.444444	-0.111111	0 	0 	-0.111111	
54	0.873243	0.387749	0.888889	0.444444	-0.111111	0 	0 	-0.111111	
114	0.860898	0.368472	0.888889	0.444444	-0.111111	0 	0 	-0.111111	
13	0.735772	0.395104	0.777778	0.333333	-0.111111	0 	0 	0.111111	
145	0.694464	0.366785	0.777778	0.333333	-0.111111	0 	0 	0.111111	
71	0.698751	0.473297	0.666667	0.444444	0.111111	0 	0 	0.111111	
173	0.73297	0.513916	0.666667	0.444444	0.111111	0 	0 	0.111111	
122	0.681982	0.527322	0.666667	0.444444	0.111111	0 	0 	0.111111	
36	0.729761	0.629242	0.777778	0.555556	-0.111111	0 	0 	0.111111	
96	0.774943	0.640169	0.777778	0.555556	-0.111111	0 	0 	0.111111	
125	0.652585	0.650545	0.666667	0.666667	-0.111111	0 	0 	-0.111111	
176	0.652389	0.584363	0.666667	0.666667	-0.111111	0 	0 	-0.111111	
65	0.577591	0.578214	0.666667	0.666667	-0.111111	0 	0 	-0.111111	
21	0.508683	0.601673	0.555556	0.555556	-0.111111	0 	0 	0.111111	
153	0.555392	0.625968	0.555556	0.555556	-0.111111	0 	0 	0.111111	
34	0.373808	0.634351	0.444444	0.666667	-0.111111	0 	0 	-0.111111	
85	0.423991	0.586617	0.444444	0.666667	-0.111111	0 	0 	-0.111111	
168	0.339803	0.51481	0.333333	0.555556	0.111111	0 	0 	-0.111111	
108	0.396978	0.466249	0.333333	0.555556	0.111111	0 	0 	-0.111111	
57	0.43704	0.51024	0.333333	0.555556	0.111111	0 	0 	-0.111111	
47	0.458466	0.459722	0.444444	0.444444	0.111111	0 	0 	0.111111	
107	0.536204	0.539784	0.444444	0.444444	0.111111	0 	0 	0.111111	
148	0.569039	0.471593	0.555556	0.555556	0.111111	0 	0 	-0.111111	
16	0.583844	0.494125	0.555556	0.555556	0.111111	0 	0 	-0.111111	
39	0.666514	0.374959	0.666667	0.444444	-0.111111	0 	0 	-0.111111	
90	0.611034	0.355685	0.666667	0.444444	-0.111111	0 	0 	-0.111111	
181	0.54116	0.341356	0.555556	0.333333	-0.111111	0 	0 	0.111111	
79	0.527653	0.419646	0.555556	0.333333	-0.111111	0 	0 	0.111111	
130	0.47385	0.40223	0.555556	0.333333	-0.111111	0 	0 	0.111111	
143	0.430236	0.350421	0.444444	0.444444	-0.111111	0 	0 	-0.111111	
2	0.339186	0.334186	0.444444	0.444444	-0.111111	0 	0 	-0.111111	
28	0.31847	0.433358	0.333333	0.333333	-0.111111	0 	0 	0.111111	
88	0.333208	0.387488	0.333333	0.333333	-0.111111	0 	0 	0.111111	
5	0.222657	0.460768	0.222222	0.444444	0.111111	0 	0 	0.111111	
137	0.291133	0.526664	0.222222	0.444444	0.111111	0 	0 	0.111111	
60	0.329547	0.645197	0.333333	0.555556	-0.111111	0 	0 	0.111111	
111	0.299623	0.576144	0.333333	0.555556	-0.111111	0 	0 	0.111111	
162	0.263267	0.650661	0.333333	0.555556	-0.111111	0 	0 	0.111111	
10	0.145705	0.622252	0.222222	0.666667	-0.111111	0 	0 	-0.111111	
151	0.187558	0.618708	0.222222	0.666667	-0.111111	0 	0 	-0.111111	
93	0.126817	0.53153	0.111111	0.555556	0.111111	0 	0 	-0.111111	
42	0.202186	0.496166	0.111111	0.555556	0.111111	0 	0 	-0.111111	
119	0.192824	0.427768	0.222222	0.444444	-0.111111	0 	0 	-0.111111	
179	0.192544	0.414559	0.222222	0.444444	-0.111111	0 	0 	-0.111111	
68	0.136522	0.362146	0.222222	0.444444	-0.111111	0 	0 	-0.111111	
24	0.096871	0.407533	0.111111	0.333333	-0.111111	0 	0 	0.111111	
156	0.0932628	0.333755	0.111111	0.333333	-0.111111	0 	0 	0.111111	
184	0.0957577	0.47023	0	0.444444	0.111111	0 	0 	0.111111	
133	0.0269901	0.497371	0	0.444444	0.111111	0 	0 	0.111111	
73	0.0590791	0.549754	0	0.444444	0.111111	0 	0 	0.111111	
101	0.0968097	0.602521	0.111111	0.555556	-0.111111	0 	0 	0.111111	
50	0.0141489	0.57009	0.111111	0.555556	-0.111111	0 	0 	0.111111	
144	0.0281518	0.6957	0	0.666667	0.111111	0 	0 	0.111111	
12	0.0372851	0.743911	0	0.666667	0.111111	0 	0 	0.111111	
167	0.124339	0.762098	0.111111	0.777778	0.111111	0 	0 	-0.111111	
116	0.173302	0.707926	0.111111	0.777778	0.111111	0 	0 	-0.111111	
56	0.208396	0.740864	0.111111	0.777778	0.111111	0 	0 	-0.111111	
52	0.223403	0.668419	0.222222	0.666667	0.111111	0 	0 	0.111111	
103	0.314707	0.763645	0.222222	0.666667	0.111111	0 	0 	0.111111	
20	0.277566	0.825104	0.333333	0.777778	-0.111111	0 	0 	0.111111	
161	0.263154	0.793239	0.333333	0.777778	-0.111111	0 	0 	0.111111	
30	0.193898	0.87261	0.222222	0.888889	-0.111111	0 	0 	-0.111111	
81	0.139233	0.831604	0.222222	0.888889	-0.111111	0 	0 	-0.111111	
121	0.105765	0.864554	0.111111	0.777778	-0.111111	0 	0 	0.111111	
172	0.0972625	0.797698	0.111111	0.777778	-0.111111	0 	0 	0.111111	
70	0.02113	0.805279	0.111111	0.777778	-0.111111	0 	0 	0.111111	
98	0.0266684	0.934569	0	0.888889	0.111111	0 	0 	0.111111	
38	0.0607391	0.974375	0	0.888889	0.111111	0 	0 	0.111111	
7	0.125813	0.985889	0.111111	1	0.111111	0 	0 	-0.111111	
139	0.188206	0.967715	0.111111	1	0.111111	0 	0 	-0.111111	
186	0.327603	0.913292	0.222222	0.888889	0.111111	0 	0 	0.111111	
126	0.223929	0.917127	0.222222	0.888889	0.111111	0 	0 	0.111111	
75	0.27749	0.983176	0.222222	0.888889	0.111111	0 	0 	0.111111	
49	0.334105	0.902925	0.333333	1	0.111111	0 	0 	-0.111111	
100	0.438986	0.986929	0.333333	1	0.111111	0 	0 	-0.111111	
72	0.424122	0.801763	0.444444	0.888889	-0.111111	0 	0 	-0.111111	
132	0.371884	0.846706	0.444444	0.888889	-0.111111	0 	0 	-0.111111	
183	0.411882	0.861061	0.444444	0.888889	-0.111111	0 	0 	-0.111111	
158	0.372644	0.670551	0.333333	0.777778	0.111111	0 	0 	-0.111111	
26	0.407559	0.702419	0.333333	0.777778	0.111111	0 	0 	-0.111111	
67	0.475364	0.679869	0.444444	0.666667	0.111111	0 	0 	0.111111	
178	0.447062	0.755656	0.444444	0.666667	0.111111	0 	0 	0.111111	
118	0.550177	0.772292	0.444444	0.666667	0.111111	0 	0 	0.111111	
44	0.55508	0.804826	0.555556	0.777778	-0.111111	0 	0 	0.111111	
95	0.542977	0.848301	0.555556	0.777778	-0.111111	0 	0 	0.111111	
150	0.444863	0.902364	0.444444	0.888889	0.111111	0 	0 	0.111111	
9	0.458524	0.900229	0.444444	0.888889	0.111111	0 	0 	0.111111	
164	0.559873	0.930136	0.555556	1	0.111111	0 	0 	-0.111111	
113	0.569711	0.989997	0.555556	1	0.111111	0 	0 	-0.111111	
62	0.639478	0.954076	0.555556	1	0.111111	0 	0 	-0.111111	
136	0.638269	0.854167	0.666667	0.888889	-0.111111	0 	0 	-0.111111	
4	0.622705	0.863296	0.666667	0.888889	-0.111111	0 	0 	-0.111111	
87	0.556599	0.694073	0.555556	0.777778	0.111111	0 	0 	-0.111111	
27	0.60782	0.751011	0.555556	0.777778	0.111111	0 	0 	-0.111111	
1	0.680621	0.699378	0.666667	0.666667	0.111111	0 	0 	0.111111	
142	0.735178	0.741464	0.666667	0.666667	0.111111	0 	0 	0.111111	
129	0.792622	0.735549	0.777778	0.777778	0.111111	0 	0 	-0.111111	
78	0.861669	0.777557	0.777778	0.777778	0.111111	0 	0 	-0.111111	
180	0.861436	0.68558	0.777778	0.777778	0.111111	0 	0 	-0.111111	
92	0.890203	0.683692	0.888889	0.666667	0.111111	0 	0 	0.111111	
41	0.973989	0.714194	0.888889	0.666667	0.111111	0 	0 	0.111111	
15	0.942688	0.791892	1	0.777778	-0.111111	0 	0 	0.111111	
147	0.969895	0.820344	1	0.777778	-0.111111	0 	0 	0.111111	
106	0.870618	0.869433	0.888889	0.888889	-0.111111	0 	0 	-0.111111	
46	0.788976	0.791711	0.888889	0.888889	-0.111111	0 	0 	-0.111111	
59	0.777426	0.861665	0.777778	0.777778	-0.111111	0 	0 	0.111111	
110	0.708121	0.781734	0.777778	0.777778	-0.111111	0 	0 	0.111111	
170	0.699038	0.888153	0.777778	0.777778	-0.111111	0 	0 	0.111111	
84	0.72709	0.999679	0.666667	0.888889	0.111111	0 	0 	0.111111	
33	0.742244	0.93086	0.666667	0.888889	0.111111	0 	0 	0.111111	
155	0.831355	0.897837	0.777778	1	0.111111	0 	0 	-0.111111	
23	0.835402	0.937817	0.777778	1	0.111111	0 	0 	-0.111111	
64	0.913915	0.929271	0.888889	0.888889	0.111111	0 	0 	0.111111	
175	0.95963	0.920606	0.888889	0.888889	0.111111	0 	0 	0.111111	
124	0.958799	0.978601	0.888889	0.888889	0.111111	0 	0 	0.111111	
