0	0.0443796	0.000201353	0	0	0.111111	0 	0 	0.111111	
141	0.118069	0.0584106	0	0	0.111111	0 	0 	0.111111	
131	0.130483	0.0573166	0.111111	0.111111	0.111111	0 	0 	-0.111111	
80	0.17876	0.0960213	0.111111	0.111111	0.111111	0 	0 	-0.111111	
91	0.251918	0.014691	0.222222	0	0.111111	0 	0 	0.111111	
40	0.280873	0.0717344	0.222222	0	0.111111	0 	0 	0.111111	
17	0.275436	0.180791	0.333333	0.111111	-0.111111	0 	0 	0.111111	
149	0.286934	0.116409	0.333333	0.111111	-0.111111	0 	0 	0.111111	
105	0.22065	0.211652	0.222222	0.222222	-0.111111	0 	0 	-0.111111	
45	0.122161	0.126912	0.222222	0.222222	-0.111111	0 	0 	-0.111111	
58	0.0968989	0.175969	0.111111	0.111111	-0.111111	0 	0 	0.111111	
109	0.054305	0.133789	0.111111	0.111111	-0.111111	0 	0 	0.111111	
169	0.0121997	0.195818	0.111111	0.111111	-0.111111	0 	0 	0.111111	
86	0.0109566	0.29362	0	0.222222	0.111111	0 	0 	0.111111	
35	0.0556249	0.308069	0	0.222222	0.111111	0 	0 	0.111111	
154	0.128311	0.278923	0.111111	0.333333	0.111111	0 	0 	-0.111111	
22	0.185216	0.254112	0.111111	0.333333	0.111111	0 	0 	-0.111111	
63	0.239717	0.23678	0.222222	0.222222	0.111111	0 	0 	0.111111	
174	0.277857	0.279459	0.222222	0.222222	0.111111	0 	0 	0.111111	
123	0.318951	0.332212	0.222222	0.222222	0.111111	0 	0 	0.111111	
97	0.349901	0.333078	0.333333	0.333333	0.111111	0 	0 	-0.111111	
37	0.430854	0.29067	0.333333	0.333333	0.111111	0 	0 	-0.111111	
120	0.430298	0.19928	0.444444	0.222222	-0.111111	0 	0 	-0.111111	
171	0.405352	0.17211	0.444444	0.222222	-0.111111	0 	0 	-0.111111	
69	0.347641	0.152456	0.444444	0.222222	-0.111111	0 	0 	-0.111111	
146	0.381089	0.0330874	0.333333	0.111111	0.111111	0 	0 	-0.111111	
14	0.361458	0.0980789	0.333333	0.111111	0.111111	0 	0 	-0.111111	
115	0.507517	0.0310196	0.444444	0	0.111111	0 	0 	0.111111	
55	0.527898	0.0684036	0.444444	0	0.111111	0 	0 	0.111111	
166	0.465206	0.0521968	0.444444	0	0.111111	0 	0 	0.111111	
32	0.553757	0.165519	0.555556	0.111111	-0.111111	0 	0 	0.111111	
83	0.483814	0.173494	0.555556	0.111111	-0.111111	0 	0 	0.111111	
6	0.460077	0.250198	0.444444	0.222222	0.111111	0 	0 	0.111111	
138	0.502673	0.321222	0.444444	0.222222	0.111111	0 	0 	0.111111	
128	0.583503	0.245489	0.555556	0.333333	0.111111	0 	0 	-0.111111	
77	0.625919	0.316218	0.555556	0.333333	0.111111	0 	0 	-0.111111	
19	0.631638	0.151441	0.666667	0.222222	-0.111111	0 	0 	-0.111111	
160	0.624946	0.20733	0.666667	0.222222	-0.111111	0 	0 	-0.111111	
51	0.555881	0.0608455	0.555556	0.111111	0.111111	0 	0 	-0.111111	
102	0.65104	0.0961354	0.555556	0.111111	0.111111	0 	0 	-0.111111	
157	0.666798	0.015012	0.666667	0	0.111111	0 	0 	0.111111	
25	0.723203	0.0589224	0.666667	0	0.111111	0 	0 	0.111111	
66	0.809376	0.0138041	0.777778	0.111111	0.111111	0 	0 	-0.111111	
177	0.78021	0.110917	0.777778	0.111111	0.111111	0 	0 	-0.111111	
117	0.790942	0.110407	0.777778	0.111111	0.111111	0 	0 	-0.111111	
89	0.925588	0.000459798	0.888889	0	0.111111	0 	0 	0.111111	
29	0.974804	0.0776114	0.888889	0	0.111111	0 	0 	0.111111	
135	0.97145	0.122719	1	0.111111	-0.111111	0 	0 	0.111111	
3	0.890116	0.111232	1	0.111111	-0.111111	0 	0 	0.111111	
43	0.888487	0.17644	0.888889	0.222222	-0.111111	0 	0 	-0.111111	
94	0.888703	0.183071	0.888889	0.222222	-0.111111	0 	0 	-0.111111	
74	0.771613	0.195378	0.777778	0.111111	-0.111111	0 	0 	0.111111	
134	0.694415	0.166486	0.777778	0.111111	-0.111111	0 	0 	0.111111	
48	0.703037	0.235369	0.666667	0.222222	0.111111	0 	0 	0.111111	
99	0.755168	0.314802	0.666667	0.222222	0.111111	0 	0 	0.111111	
152	0.778581	0.263689	0.777778	0.333333	0.111111	0 	0 	-0.111111	
11	0.827714	0.278437	0.777778	0.333333	0.111111	0 	0 	-0.111111	
112	0.917409	0.225668	0.888889	0.222222	0.111111	0 	0 	0.111111	
61	0.985238	0.291376	0.888889	0.222222	0.111111	0 	0 	0.111111	
163	0.931516	0.301112	0.888889	0.222222	0.111111	0 	0 	0.111111	
104	0.97112	0.43293	1	0.333333	-0.111111	0 	0 	0.111111	
53	0.90635	0.351287	1	0.333333	-0.111111	0 	0 	0.111111	
159	0.917583	0.519686	0.888889	0.444444	0.111111	0 	0 	0.111111	
18	0.958807	0.479827	0.888889	0.444444	0.111111	0 	0 	0.111111	
76	0.972157	0.570805	1	0.555556	-0.111111	0 	0 	0.111111	
127	0.915839	0.618121	1	0.555556	-0.111111	0 	0 	0.111111	
140	0.874315	0.664877	0.888889	0.666667	-0.111111	0 	0 	-0.111111	
8	0.883529	0.597104	0.888889	0.666667	-0.111111	0 	0 	-0.111111	
82	0.808177	0.476317	0.777778	0.555556	0.111111	0 	0 	-0.111111	
31	0.829517	0.50145	0.777778	0.555556	0.111111	0 	0 	-0.111111	
165	0.806714	0.435235	0.888889	0.444444	-0.111111	0 	0 	-0.111111	
54	0.880164	0.387959	0.888889	0.444444	-0.111111	0 	0 	-0.111111	
114	0.809653	0.346817	0.888889	0.444444	-0.111111	0 	0 	-0.111111	
13	0.722854	0.410694	0.777778	0.333333	-0.111111	0 	0 	0.111111	
145	0.677045	0.375719	0.777778	0.333333	-0.111111	0 	0 	0.111111	
71	0.672676	0.461041	0.666667	0.444444	0.111111	0 	0 	0.111111	
173	0.693978	0.527989	0.666667	0.444444	0.111111	0 	0 	0.111111	
122	0.768694	0.549421	0.666667	0.444444	0.111111	0 	0 	0.111111	
36	0.763514	0.600202	0.777778	0.555556	-0.111111	0 	0 	0.111111	
96	0.777361	0.623521	0.777778	0.555556	-0.111111	0 	0 	0.111111	
125	0.66662	0.599638	0.666667	0.666667	-0.111111	0 	0 	-0.111111	
176	0.648323	0.636696	0.666667	0.666667	-0.111111	0 	0 	-0.111111	
65	0.601589	0.591625	0.666667	0.666667	-0.111111	0 	0 	-0.111111	
21	0.527459	0.603437	0.555556	0.555556	-0.111111	0 	0 	0.111111	
153	0.486966	0.559351	0.555556	0.555556	-0.111111	0 	0 	0.111111	
34	0.385339	0.631271	0.444444	0.666667	-0.111111	0 	0 	-0.111111	
85	0.349572	0.614148	0.444444	0.666667	-0.111111	0 	0 	-0.111111	
168	0.347667	0.502025	0.333333	0.555556	0.111111	0 	0 	-0.111111	
108	0.389673	0.455406	0.333333	0.555556	0.111111	0 	0 	-0.111111	
57	0.425724	0.507764	0.333333	0.555556	0.111111	0 	0 	-0.111111	
47	0.487437	0.472599	0.444444	0.444444	0.111111	0 	0 	0.111111	
107	0.512594	0.539993	0.444444	0.444444	0.111111	0 	0 	0.111111	
148	0.56999	0.465424	0.555556	0.555556	0.111111	0 	0 	-0.111111	
16	0.595306	0.52302	0.555556	0.555556	0.111111	0 	0 	-0.111111	
39	0.638885	0.405565	0.666667	0.444444	-0.111111	0 	0 	-0.111111	
90	0.611077	0.350821	0.666667	0.444444	-0.111111	0 	0 	-0.111111	
79	0.5552	0.334042	0.555556	0.333333	-0.111111	0 	0 	0.111111	
130	0.478965	0.401403	0.555556	0.333333	-0.111111	0 	0 	0.111111	
143	0.415126	0.388994	0.444444	0.444444	-0.111111	0 	0 	-0.111111	
2	0.331937	0.338354	0.444444	0.444444	-0.111111	0 	0 	-0.111111	
28	0.31806	0.430868	0.333333	0.333333	-0.111111	0 	0 	0.111111	
88	0.222208	0.383755	0.333333	0.333333	-0.111111	0 	0 	0.111111	
5	0.235024	0.51517	0.222222	0.444444	0.111111	0 	0 	0.111111	
137	0.292277	0.533371	0.222222	0.444444	0.111111	0 	0 	0.111111	
60	0.333009	0.640381	0.333333	0.555556	-0.111111	0 	0 	0.111111	
111	0.27839	0.58104	0.333333	0.555556	-0.111111	0 	0 	0.111111	
162	0.251722	0.658923	0.333333	0.555556	-0.111111	0 	0 	0.111111	
10	0.152688	0.621274	0.222222	0.666667	-0.111111	0 	0 	-0.111111	
151	0.117612	0.601459	0.222222	0.666667	-0.111111	0 	0 	-0.111111	
93	0.169901	0.471936	0.111111	0.555556	0.111111	0 	0 	-0.111111	
42	0.115048	0.445196	0.111111	0.555556	0.111111	0 	0 	-0.111111	
119	0.209526	0.444231	0.222222	0.444444	-0.111111	0 	0 	-0.111111	
68	0.1333	0.361499	0.222222	0.444444	-0.111111	0 	0 	-0.111111	
24	0.110927	0.413737	0.111111	0.333333	-0.111111	0 	0 	0.111111	
156	0.105682	0.338904	0.111111	0.333333	-0.111111	0 	0 	0.111111	
133	0.0248714	0.475213	0	0.444444	0.111111	0 	0 	0.111111	
73	0.059021	0.547031	0	0.444444	0.111111	0 	0 	0.111111	
101	0.0977081	0.571393	0.111111	0.555556	-0.111111	0 	0 	0.111111	
50	0.0129099	0.565669	0.111111	0.555556	-0.111111	0 	0 	0.111111	
144	0.0505909	0.67135	0	0.666667	0.111111	0 	0 	0.111111	
12	0.0347168	0.731046	0	0.666667	0.111111	0 	0 	0.111111	
167	0.114619	0.763592	0.111111	0.777778	0.111111	0 	0 	-0.111111	
116	0.166878	0.719338	0.111111	0.777778	0.111111	0 	0 	-0.111111	
56	0.205813	0.734451	0.111111	0.777778	0.111111	0 	0 	-0.111111	
52	0.223297	0.667232	0.222222	0.666667	0.111111	0 	0 	0.111111	
103	0.317534	0.764196	0.222222	0.666667	0.111111	0 	0 	0.111111	
20	0.305184	0.844797	0.333333	0.777778	-0.111111	0 	0 	0.111111	
161	0.277537	0.791193	0.333333	0.777778	-0.111111	0 	0 	0.111111	
30	0.203289	0.832814	0.222222	0.888889	-0.111111	0 	0 	-0.111111	
81	0.203597	0.869111	0.222222	0.888889	-0.111111	0 	0 	-0.111111	
121	0.101494	0.85715	0.111111	0.777778	-0.111111	0 	0 	0.111111	
172	0.101651	0.796003	0.111111	0.777778	-0.111111	0 	0 	0.111111	
70	0.0174739	0.80659	0.111111	0.777778	-0.111111	0 	0 	0.111111	
98	0.0223384	0.920756	0	0.888889	0.111111	0 	0 	0.111111	
38	0.0597046	0.972805	0	0.888889	0.111111	0 	0 	0.111111	
7	0.139498	0.977529	0.111111	1	0.111111	0 	0 	-0.111111	
139	0.167365	0.954991	0.111111	1	0.111111	0 	0 	-0.111111	
126	0.2382	0.932848	0.222222	0.888889	0.111111	0 	0 	0.111111	
75	0.29389	0.987159	0.222222	0.888889	0.111111	0 	0 	0.111111	
49	0.346801	0.889056	0.333333	1	0.111111	0 	0 	-0.111111	
100	0.34633	0.971832	0.333333	1	0.111111	0 	0 	-0.111111	
72	0.401956	0.868002	0.444444	0.888889	-0.111111	0 	0 	-0.111111	
132	0.416606	0.860077	0.444444	0.888889	-0.111111	0 	0 	-0.111111	
158	0.359225	0.749801	0.333333	0.777778	0.111111	0 	0 	-0.111111	
26	0.412412	0.702119	0.333333	0.777778	0.111111	0 	0 	-0.111111	
67	0.458989	0.679476	0.444444	0.666667	0.111111	0 	0 	0.111111	
178	0.502006	0.721395	0.444444	0.666667	0.111111	0 	0 	0.111111	
118	0.549572	0.771109	0.444444	0.666667	0.111111	0 	0 	0.111111	
44	0.555229	0.861311	0.555556	0.777778	-0.111111	0 	0 	0.111111	
95	0.48596	0.7987	0.555556	0.777778	-0.111111	0 	0 	0.111111	
150	0.459033	0.891585	0.444444	0.888889	0.111111	0 	0 	0.111111	
9	0.45859	0.933392	0.444444	0.888889	0.111111	0 	0 	0.111111	
164	0.556341	0.999999	0.555556	1	0.111111	0 	0 	-0.111111	
113	0.557049	0.971443	0.555556	1	0.111111	0 	0 	-0.111111	
62	0.651973	0.944419	0.555556	1	0.111111	0 	0 	-0.111111	
136	0.638835	0.859282	0.666667	0.888889	-0.111111	0 	0 	-0.111111	
4	0.557352	0.778202	0.666667	0.888889	-0.111111	0 	0 	-0.111111	
87	0.583652	0.691529	0.555556	0.777778	0.111111	0 	0 	-0.111111	
27	0.610652	0.750796	0.555556	0.777778	0.111111	0 	0 	-0.111111	
1	0.695178	0.710037	0.666667	0.666667	0.111111	0 	0 	0.111111	
142	0.721992	0.750799	0.666667	0.666667	0.111111	0 	0 	0.111111	
129	0.833542	0.725572	0.777778	0.777778	0.111111	0 	0 	-0.111111	
78	0.835974	0.768545	0.777778	0.777778	0.111111	0 	0 	-0.111111	
92	0.944876	0.70873	0.888889	0.666667	0.111111	0 	0 	0.111111	
41	0.972155	0.711958	0.888889	0.666667	0.111111	0 	0 	0.111111	
15	0.943498	0.792466	1	0.777778	-0.111111	0 	0 	0.111111	
147	0.974468	0.843771	1	0.777778	-0.111111	0 	0 	0.111111	
106	0.88595	0.861074	0.888889	0.888889	-0.111111	0 	0 	-0.111111	
46	0.781293	0.792842	0.888889	0.888889	-0.111111	0 	0 	-0.111111	
59	0.777745	0.779594	0.777778	0.777778	-0.111111	0 	0 	0.111111	
110	0.729269	0.804619	0.777778	0.777778	-0.111111	0 	0 	0.111111	
170	0.695739	0.886525	0.777778	0.777778	-0.111111	0 	0 	0.111111	
84	0.667343	0.918733	0.666667	0.888889	0.111111	0 	0 	0.111111	
33	0.724251	0.94727	0.666667	0.888889	0.111111	0 	0 	0.111111	
155	0.821663	0.905186	0.777778	1	0.111111	0 	0 	-0.111111	
23	0.823773	0.987598	0.777778	1	0.111111	0 	0 	-0.111111	
64	0.902983	0.908557	0.888889	0.888889	0.111111	0 	0 	0.111111	
175	0.903908	0.928856	0.888889	0.888889	0.111111	0 	0 	0.111111	
124	0.984934	0.99749	0.888889	0.888889	0.111111	0 	0 	0.111111	
