0	0.2639939150628315	0.5470482606991566	0.2222222222222222	0.4444444444444444	0.1111111111111111	0.	0.	0.1111111111111111
1	0.9306676076872813	0.01105603632646285	0.8888888888888888	0.	0.1111111111111111	0.	0.	0.1111111111111111
2	0.3992347696062783	0.9692821847633362	0.3333333333333333	0.8888888888888888	0.1111111111111111	0.	0.	0.1111111111111111
3	0.771532750986401	0.5849453555014915	0.6666666666666666	0.5555555555555556	0.1111111111111111	0.	0.	0.1111111111111111
4	0.5120396424533621	0.1563121914976125	0.4444444444444444	0.1111111111111111	0.1111111111111111	0.	0.	0.1111111111111111
5	0.08291311183940335	0.6938267695318854	0.	0.6666666666666666	0.1111111111111111	0.	0.	0.1111111111111111
6	0.6224743446648223	0.35185842223228414	0.5555555555555556	0.3333333333333333	0.1111111111111111	0.	0.	0.1111111111111111
7	0.21503057108577442	0.24451821218297354	0.1111111111111111	0.2222222222222222	0.1111111111111111	0.	0.	0.1111111111111111
8	0.8101275295914118	0.8869701536788538	0.7777777777777778	0.7777777777777778	0.1111111111111111	0.	0.	0.1111111111111111
9	0.35460684338423487	0.641044602401845	0.3333333333333333	0.5555555555555556	0.1111111111111111	0.	0.	0.1111111111111111
10	0.23907916238265864	0.12868595083519194	0.2222222222222222	0.1111111111111111	0.1111111111111111	0.	0.	0.1111111111111111
11	0.9113845783205339	0.7498027954496406	0.8888888888888888	0.6666666666666666	0.1111111111111111	0.	0.	0.1111111111111111
12	0.06002512341743152	0.4299806422129281	0.	0.3333333333333333	0.1111111111111111	0.	0.	0.1111111111111111
13	0.7311610572391108	0.3095135210225463	0.6666666666666666	0.2222222222222222	0.1111111111111111	0.	0.	0.1111111111111111
14	0.4480800291385725	0.8344767709656851	0.4444444444444444	0.7777777777777778	0.1111111111111111	0.	0.	0.1111111111111111
15	0.8650549893864804	0.4974677845015403	0.7777777777777778	0.4444444444444444	0.1111111111111111	0.	0.	0.1111111111111111
16	0.573516348021542	0.0957128788646316	0.5555555555555556	0.	0.1111111111111111	0.	0.	0.1111111111111111
17	0.1849676988388018	0.9308902228279758	0.1111111111111111	0.8888888888888888	0.1111111111111111	0.	0.	0.1111111111111111
18	0.9823567040788767	0.4016516569244569	0.8888888888888888	0.3333333333333333	0.1111111111111111	0.	0.	0.1111111111111111
19	0.42858644732132384	0.27671102856927127	0.3333333333333333	0.2222222222222222	0.1111111111111111	0.	0.	0.1111111111111111
20	0.31806584189201215	0.7793301152261293	0.2222222222222222	0.7777777777777778	0.1111111111111111	0.	0.	0.1111111111111111
21	0.5361785619620821	0.4779251956393046	0.4444444444444444	0.4444444444444444	0.1111111111111111	0.	0.	0.1111111111111111
22	0.03128452162649216	0.06659935926448468	0.	0.	0.1111111111111111	0.	0.	0.1111111111111111
23	0.6902428023108504	0.9109229515564763	0.6666666666666666	0.8888888888888888	0.1111111111111111	0.	0.	0.1111111111111111
24	0.12468923225517212	0.5948082558259674	0.1111111111111111	0.5555555555555556	0.1111111111111111	0.	0.	0.1111111111111111
25	0.8300661102447098	0.19187081593233274	0.7777777777777778	0.1111111111111111	0.1111111111111111	0.	0.	0.1111111111111111
26	0.6609430741800545	0.7292761242337564	0.5555555555555556	0.6666666666666666	0.1111111111111111	0.	0.	0.1111111111111111
27	0.9222875139850095	0.1634259126651404	0.8888888888888888	0.1111111111111111	0.1111111111111111	0.	0.	0.1111111111111111
28	0.3603526701105028	0.6685008770061892	0.3333333333333333	0.6666666666666666	0.1111111111111111	0.	0.	0.1111111111111111
29	0.25035175497218826	0.5591813739446635	0.2222222222222222	0.5555555555555556	0.1111111111111111	0.	0.	0.1111111111111111
30	0.4679080684002406	0.2538656966419073	0.4444444444444444	0.2222222222222222	0.1111111111111111	0.	0.	0.1111111111111111
31	0.06886004679014279	0.8552311628860015	0.	0.7777777777777778	0.1111111111111111	0.	0.	0.1111111111111111
32	0.7038235313018427	0.35879856025546103	0.6666666666666666	0.3333333333333333	0.1111111111111111	0.	0.	0.1111111111111111
33	0.15137592701419222	0.02200142629352092	0.1111111111111111	0.	0.1111111111111111	0.	0.	0.1111111111111111
34	0.8767290338121483	0.9799125346035412	0.7777777777777778	0.8888888888888888	0.1111111111111111	0.	0.	0.1111111111111111
35	0.5879705947439795	0.522147546168284	0.5555555555555556	0.4444444444444444	0.1111111111111111	0.	0.	0.1111111111111111
36	0.33270340192737374	0.3278452601405912	0.2222222222222222	0.2222222222222222	0.1111111111111111	0.	0.	0.1111111111111111
37	0.9906469178333348	0.8405737596392328	0.8888888888888888	0.7777777777777778	0.1111111111111111	0.	0.	0.1111111111111111
38	0.43404635731591373	0.440003471267107	0.3333333333333333	0.3333333333333333	0.1111111111111111	0.	0.	0.1111111111111111
39	0.6940979228041465	0.10054143264477682	0.6666666666666666	0.	0.1111111111111111	0.	0.	0.1111111111111111
40	0.5545829353387658	0.9389462276649666	0.4444444444444444	0.8888888888888888	0.1111111111111111	0.	0.	0.1111111111111111
41	0.01183821230477049	0.5153101139504611	0.	0.4444444444444444	0.1111111111111111	0.	0.	0.1111111111111111
42	0.635091799012554	0.1363901587559041	0.5555555555555556	0.1111111111111111	0.1111111111111111	0.	0.	0.1111111111111111
43	0.1456858037607127	0.7612972503372171	0.1111111111111111	0.6666666666666666	0.1111111111111111	0.	0.	0.1111111111111111
44	0.8433812320476767	0.6460023887206786	0.7777777777777778	0.5555555555555556	0.1111111111111111	0.	0.	0.1111111111111111
45	0.37111732449786194	0.046642103811568594	0.3333333333333333	0.	0.1111111111111111	0.	0.	0.1111111111111111
46	0.2802231186762729	0.9160531732572703	0.2222222222222222	0.8888888888888888	0.1111111111111111	0.	0.	0.1111111111111111
47	0.9420692194383831	0.44644908287233104	0.8888888888888888	0.4444444444444444	0.1111111111111111	0.	0.	0.1111111111111111
48	0.09251217049941139	0.20122620480887032	0.	0.1111111111111111	0.1111111111111111	0.	0.	0.1111111111111111
49	0.7519322586300626	0.7039830668325857	0.6666666666666666	0.6666666666666666	0.1111111111111111	0.	0.	0.1111111111111111
50	0.4889241277754586	0.6073743671655254	0.4444444444444444	0.5555555555555556	0.1111111111111111	0.	0.	0.1111111111111111
51	0.7887565285686272	0.2844389230706553	0.7777777777777778	0.2222222222222222	0.1111111111111111	0.	0.	0.1111111111111111
52	0.5996897856375377	0.791409464321508	0.5555555555555556	0.7777777777777778	0.1111111111111111	0.	0.	0.1111111111111111
53	0.1968369308418275	0.375351471580706	0.1111111111111111	0.3333333333333333	0.1111111111111111	0.	0.	0.1111111111111111
54	0.41705395538162504	0.8701657404254287	0.3333333333333333	0.7777777777777778	0.1111111111111111	0.	0.	0.1111111111111111
55	0.3019967752230402	0.3445844402238968	0.2222222222222222	0.3333333333333333	0.1111111111111111	0.	0.	0.1111111111111111
56	0.9668276338029883	0.22466630651878952	0.8888888888888888	0.2222222222222222	0.1111111111111111	0.	0.	0.1111111111111111
57	0.01989993014196693	0.9885189766856479	0.	0.8888888888888888	0.1111111111111111	0.	0.	0.1111111111111111
58	0.6678357349345043	0.5413138685772159	0.6666666666666666	0.4444444444444444	0.1111111111111111	0.	0.	0.1111111111111111
59	0.5295513371777301	0.030100126342741434	0.4444444444444444	0.	0.1111111111111111	0.	0.	0.1111111111111111
60	0.8228692201838265	0.6842435739117556	0.7777777777777778	0.6666666666666666	0.1111111111111111	0.	0.	0.1111111111111111
61	0.6488536318308487	0.5710449135968817	0.5555555555555556	0.5555555555555556	0.1111111111111111	0.	0.	0.1111111111111111
62	0.12164568904184452	0.1837656156245951	0.1111111111111111	0.1111111111111111	0.1111111111111111	0.	0.	0.1111111111111111
63	0.9512484087197223	0.9615573739054365	0.8888888888888888	0.8888888888888888	0.1111111111111111	0.	0.	0.1111111111111111
64	0.3934838355954891	0.4899099489805249	0.3333333333333333	0.4444444444444444	0.1111111111111111	0.	0.	0.1111111111111111
65	0.2947213400132451	0.07679523113709147	0.2222222222222222	0.	0.1111111111111111	0.	0.	0.1111111111111111
66	0.4973931756441858	0.769738681356456	0.4444444444444444	0.6666666666666666	0.1111111111111111	0.	0.	0.1111111111111111
67	0.10042041082310102	0.6558355255186311	0.	0.5555555555555556	0.1111111111111111	0.	0.	0.1111111111111111
68	0.7544092623695319	0.11809636376768912	0.6666666666666666	0.1111111111111111	0.1111111111111111	0.	0.	0.1111111111111111
69	0.208354758267143	0.8228188881357796	0.1111111111111111	0.7777777777777778	0.1111111111111111	0.	0.	0.1111111111111111
70	0.796208320825283	0.41854600863232444	0.7777777777777778	0.3333333333333333	0.1111111111111111	0.	0.	0.1111111111111111
71	0.6064372114299821	0.30412865180189275	0.5555555555555556	0.2222222222222222	0.1111111111111111	0.	0.	0.1111111111111111
72	0.22389240922843054	0.7195482744159495	0.2222222222222222	0.6666666666666666	0.1111111111111111	0.	0.	0.1111111111111111
73	0.8946321421838895	0.6201000209189591	0.8888888888888888	0.5555555555555556	0.1111111111111111	0.	0.	0.1111111111111111
74	0.34536410127756567	0.22092139186440052	0.3333333333333333	0.1111111111111111	0.1111111111111111	0.	0.	0.1111111111111111
75	0.7208381287581652	0.8132102550380775	0.6666666666666666	0.7777777777777778	0.1111111111111111	0.	0.	0.1111111111111111
76	0.47270221339962915	0.3896412983293028	0.4444444444444444	0.3333333333333333	0.1111111111111111	0.	0.	0.1111111111111111
77	0.04431143203339117	0.2670791975933244	0.	0.2222222222222222	0.1111111111111111	0.	0.	0.1111111111111111
78	0.5623291570415626	0.8924062411508994	0.5555555555555556	0.8888888888888888	0.1111111111111111	0.	0.	0.1111111111111111
79	0.17173328004687263	0.4604929649620743	0.1111111111111111	0.4444444444444444	0.1111111111111111	0.	0.	0.1111111111111111
80	0.8545400352672968	0.061711409210815735	0.7777777777777778	0.	0.1111111111111111	0.	0.	0.1111111111111111
81	0.7117218960507792	0.21408059895699874	0.6666666666666666	0.1111111111111111	0.1111111111111111	0.	0.	0.1111111111111111
82	0.4583595345159971	0.7246270369557043	0.4444444444444444	0.6666666666666666	0.1111111111111111	0.	0.	0.1111111111111111
83	0.07341452971012073	0.6292665374924625	0.	0.5555555555555556	0.1111111111111111	0.	0.	0.1111111111111111
84	0.5915793980288603	0.26220274065061133	0.5555555555555556	0.2222222222222222	0.1111111111111111	0.	0.	0.1111111111111111
85	0.1554304707926792	0.8078100777301258	0.1111111111111111	0.7777777777777778	0.1111111111111111	0.	0.	0.1111111111111111
86	0.8812749283032026	0.38602977964854107	0.7777777777777778	0.3333333333333333	0.1111111111111111	0.	0.	0.1111111111111111
87	0.252636104127162	0.057281307941700874	0.2222222222222222	0.	0.1111111111111111	0.	0.	0.1111111111111111
88	0.9157695391444995	0.8988614375185167	0.8888888888888888	0.8888888888888888	0.1111111111111111	0.	0.	0.1111111111111111
89	0.3638176202222834	0.46622557177145063	0.3333333333333333	0.4444444444444444	0.1111111111111111	0.	0.	0.1111111111111111
90	0.001507779488313708	0.23277538891341393	0.	0.2222222222222222	0.1111111111111111	0.	0.	0.1111111111111111
91	0.6990161018561929	0.864335714056672	0.6666666666666666	0.7777777777777778	0.1111111111111111	0.	0.	0.1111111111111111
92	0.5439067240452531	0.3393104591326867	0.4444444444444444	0.3333333333333333	0.1111111111111111	0.	0.	0.1111111111111111
93	0.8443264634187516	0.025715714448614684	0.7777777777777778	0.	0.1111111111111111	0.	0.	0.1111111111111111
94	0.6380114561605785	0.9960436793866454	0.5555555555555556	0.8888888888888888	0.1111111111111111	0.	0.	0.1111111111111111
95	0.1387095163845778	0.5378290460007138	0.1111111111111111	0.4444444444444444	0.1111111111111111	0.	0.	0.1111111111111111
96	0.4380157145827497	0.18006975877829734	0.3333333333333333	0.1111111111111111	0.1111111111111111	0.	0.	0.1111111111111111
97	0.3234606537979633	0.6795261457291348	0.2222222222222222	0.6666666666666666	0.1111111111111111	0.	0.	0.1111111111111111
98	0.9917992437410816	0.5787446104844497	0.8888888888888888	0.5555555555555556	0.1111111111111111	0.	0.	0.1111111111111111
99	0.49300522065746166	0.08356672638446853	0.4444444444444444	0.	0.1111111111111111	0.	0.	0.1111111111111111
100	0.0983983365594964	0.9574490229572414	0.	0.8888888888888888	0.1111111111111111	0.	0.	0.1111111111111111
101	0.7423809086841215	0.48642123571322016	0.6666666666666666	0.4444444444444444	0.1111111111111111	0.	0.	0.1111111111111111
102	0.1871445455052671	0.11129049329482761	0.1111111111111111	0.1111111111111111	0.1111111111111111	0.	0.	0.1111111111111111
103	0.7813040875767071	0.7660295176937153	0.7777777777777778	0.6666666666666666	0.1111111111111111	0.	0.	0.1111111111111111
104	0.6023996388757505	0.6636765864664083	0.5555555555555556	0.5555555555555556	0.1111111111111111	0.	0.	0.1111111111111111
105	0.9452967178167664	0.2985551245157128	0.8888888888888888	0.2222222222222222	0.1111111111111111	0.	0.	0.1111111111111111
106	0.37813387992153064	0.8179572531591122	0.3333333333333333	0.7777777777777778	0.1111111111111111	0.	0.	0.1111111111111111
107	0.2735901301286108	0.41334272763944263	0.2222222222222222	0.3333333333333333	0.1111111111111111	0.	0.	0.1111111111111111
108	0.5206554438752635	0.7878620258861254	0.4444444444444444	0.7777777777777778	0.1111111111111111	0.	0.	0.1111111111111111
109	0.02248879081181825	0.397206685507367	0.	0.3333333333333333	0.1111111111111111	0.	0.	0.1111111111111111
110	0.6708441225471686	0.2717231466127578	0.6666666666666666	0.2222222222222222	0.1111111111111111	0.	0.	0.1111111111111111
111	0.11194657028064411	0.908160216929914	0.1111111111111111	0.8888888888888888	0.1111111111111111	0.	0.	0.1111111111111111
112	0.8240921567091753	0.47623530050316987	0.7777777777777778	0.4444444444444444	0.1111111111111111	0.	0.	0.1111111111111111
113	0.6541512547623676	0.06577596622671138	0.5555555555555556	0.	0.1111111111111111	0.	0.	0.1111111111111111
114	0.9682603897251978	0.739495467589136	0.8888888888888888	0.6666666666666666	0.1111111111111111	0.	0.	0.1111111111111111
115	0.40772744813022355	0.6029843532617088	0.3333333333333333	0.5555555555555556	0.1111111111111111	0.	0.	0.1111111111111111
116	0.30656698438063257	0.1874929481766946	0.2222222222222222	0.1111111111111111	0.1111111111111111	0.	0.	0.1111111111111111
117	0.7594799759458944	0.9658050386006647	0.6666666666666666	0.8888888888888888	0.1111111111111111	0.	0.	0.1111111111111111
118	0.49961006837715294	0.5520462522569373	0.4444444444444444	0.4444444444444444	0.1111111111111111	0.	0.	0.1111111111111111
119	0.1068006309461518	0.008216475613399993	0.	0.	0.1111111111111111	0.	0.	0.1111111111111111
120	0.6108482292134702	0.701693754938879	0.5555555555555556	0.6666666666666666	0.1111111111111111	0.	0.	0.1111111111111111
121	0.19855974628125572	0.5836079800105772	0.1111111111111111	0.5555555555555556	0.1111111111111111	0.	0.	0.1111111111111111
122	0.7985721873716735	0.1495652552679869	0.7777777777777778	0.1111111111111111	0.1111111111111111	0.	0.	0.1111111111111111
123	0.28566009923479635	0.8822529724286214	0.2222222222222222	0.7777777777777778	0.1111111111111111	0.	0.	0.1111111111111111
124	0.9569752259540408	0.3492384954030314	0.8888888888888888	0.3333333333333333	0.1111111111111111	0.	0.	0.1111111111111111
125	0.38561659723336594	0.23932538236682332	0.3333333333333333	0.2222222222222222	0.1111111111111111	0.	0.	0.1111111111111111
126	0.04931997371293736	0.7463221018924137	0.	0.6666666666666666	0.1111111111111111	0.	0.	0.1111111111111111
127	0.7283321559175462	0.6345658252817222	0.6666666666666666	0.5555555555555556	0.1111111111111111	0.	0.	0.1111111111111111
128	0.47630476938112243	0.12693602187536	0.4444444444444444	0.1111111111111111	0.1111111111111111	0.	0.	0.1111111111111111
129	0.8570182263471702	0.8300311843686031	0.7777777777777778	0.7777777777777778	0.1111111111111111	0.	0.	0.1111111111111111
130	0.5667480018074109	0.4251888710339565	0.5555555555555556	0.3333333333333333	0.1111111111111111	0.	0.	0.1111111111111111
131	0.16322196630132282	0.3206052093956239	0.1111111111111111	0.2222222222222222	0.1111111111111111	0.	0.	0.1111111111111111
132	0.3337667891557141	0.9261951622457083	0.3333333333333333	0.8888888888888888	0.1111111111111111	0.	0.	0.1111111111111111
133	0.2263521457689348	0.5023917040863233	0.2222222222222222	0.4444444444444444	0.1111111111111111	0.	0.	0.1111111111111111
134	0.8987004014648281	0.0928261463218586	0.8888888888888888	0.	0.1111111111111111	0.	0.	0.1111111111111111
135	0.0778451583992847	0.45464520248093193	0.	0.4444444444444444	0.1111111111111111	0.	0.	0.1111111111111111
136	0.7756746778562866	0.04297882999505825	0.6666666666666666	0.	0.1111111111111111	0.	0.	0.1111111111111111
137	0.515350213361242	0.9223732606115902	0.4444444444444444	0.8888888888888888	0.1111111111111111	0.	0.	0.1111111111111111
138	0.8117270294051658	0.6168812692815532	0.7777777777777778	0.5555555555555556	0.1111111111111111	0.	0.	0.1111111111111111
139	0.6264414838421207	0.20676239626207973	0.5555555555555556	0.1111111111111111	0.1111111111111111	0.	0.	0.1111111111111111
140	0.22146588810553763	0.7151743386499108	0.1111111111111111	0.6666666666666666	0.1111111111111111	0.	0.	0.1111111111111111
141	0.40552093171991915	0.37198254805430975	0.3333333333333333	0.3333333333333333	0.1111111111111111	0.	0.	0.1111111111111111
142	0.2692652642161456	0.2930738836926442	0.2222222222222222	0.2222222222222222	0.1111111111111111	0.	0.	0.1111111111111111
143	0.9367234137170274	0.7985686864382644	0.8888888888888888	0.7777777777777778	0.1111111111111111	0.	0.	0.1111111111111111
144	0.45147632602363474	0.5638891924135347	0.4444444444444444	0.5555555555555556	0.1111111111111111	0.	0.	0.1111111111111111
145	0.049649726536103084	0.1697467649075903	0.	0.1111111111111111	0.1111111111111111	0.	0.	0.1111111111111111
146	0.732945667723836	0.6773779113852357	0.6666666666666666	0.6666666666666666	0.1111111111111111	0.	0.	0.1111111111111111
147	0.17355722505424853	0.36707512475762055	0.1111111111111111	0.3333333333333333	0.1111111111111111	0.	0.	0.1111111111111111
148	0.8702669706591935	0.24845303419148804	0.7777777777777778	0.2222222222222222	0.1111111111111111	0.	0.	0.1111111111111111
149	0.576236602533774	0.8635627236190565	0.5555555555555556	0.7777777777777778	0.1111111111111111	0.	0.	0.1111111111111111
150	0.9049430320656067	0.5306734977560777	0.8888888888888888	0.4444444444444444	0.1111111111111111	0.	0.	0.1111111111111111
151	0.3495894826908169	0.020104082139376304	0.3333333333333333	0.	0.1111111111111111	0.	0.	0.1111111111111111
152	0.24350136955886884	0.9785779011806472	0.2222222222222222	0.8888888888888888	0.1111111111111111	0.	0.	0.1111111111111111
153	0.6827730011976728	0.43327878648496915	0.6666666666666666	0.3333333333333333	0.1111111111111111	0.	0.	0.1111111111111111
154	0.540922013548953	0.32310860220577203	0.4444444444444444	0.2222222222222222	0.1111111111111111	0.	0.	0.1111111111111111
155	0.03684311337493563	0.8503161879322634	0.	0.7777777777777778	0.1111111111111111	0.	0.	0.1111111111111111
156	0.6651052968273274	0.5140883191647616	0.5555555555555556	0.4444444444444444	0.1111111111111111	0.	0.	0.1111111111111111
157	0.1291618308464493	0.10815088305771052	0.1111111111111111	0.	0.1111111111111111	0.	0.	0.1111111111111111
158	0.834175054863107	0.947645073223442	0.7777777777777778	0.8888888888888888	0.1111111111111111	0.	0.	0.1111111111111111
159	0.3107822613549658	0.6526879325682746	0.2222222222222222	0.5555555555555556	0.1111111111111111	0.	0.	0.1111111111111111
160	0.9874711857757907	0.14433498895304941	0.8888888888888888	0.1111111111111111	0.1111111111111111	0.	0.	0.1111111111111111
161	0.4230233978840151	0.7534919885630177	0.3333333333333333	0.6666666666666666	0.1111111111111111	0.	0.	0.1111111111111111
162	0.6427099367994448	0.8475283754718164	0.5555555555555556	0.7777777777777778	0.1111111111111111	0.	0.	0.1111111111111111
163	0.11571193644329951	0.44351143493600836	0.1111111111111111	0.3333333333333333	0.1111111111111111	0.	0.	0.1111111111111111
164	0.8179559832211145	0.330169676011465	0.7777777777777778	0.2222222222222222	0.1111111111111111	0.	0.	0.1111111111111111
165	0.29904381919941947	0.944708051652202	0.2222222222222222	0.8888888888888888	0.1111111111111111	0.	0.	0.1111111111111111
166	0.9734606593474893	0.5093066240317851	0.8888888888888888	0.4444444444444444	0.1111111111111111	0.	0.	0.1111111111111111
167	0.4119103683577597	0.10450107695087171	0.3333333333333333	0.	0.1111111111111111	0.	0.	0.1111111111111111
168	0.6762164971610471	0.763148002565588	0.6666666666666666	0.6666666666666666	0.1111111111111111	0.	0.	0.1111111111111111
169	0.523431655675805	0.6480239321226676	0.4444444444444444	0.5555555555555556	0.1111111111111111	0.	0.	0.1111111111111111
170	0.013134538512580661	0.14009006890701642	0.	0.1111111111111111	0.1111111111111111	0.	0.	0.1111111111111111
171	0.7904153566849689	0.9189659438309505	0.7777777777777778	0.8888888888888888	0.1111111111111111	0.	0.	0.1111111111111111
172	0.615880701824902	0.4497299874779381	0.5555555555555556	0.4444444444444444	0.1111111111111111	0.	0.	0.1111111111111111
173	0.20432068922749552	0.039856579879198564	0.1111111111111111	0.	0.1111111111111111	0.	0.	0.1111111111111111
174	0.3899400004801157	0.7115791028801268	0.3333333333333333	0.6666666666666666	0.1111111111111111	0.	0.	0.1111111111111111
175	0.2897757084465057	0.6122684475093245	0.2222222222222222	0.5555555555555556	0.1111111111111111	0.	0.	0.1111111111111111
176	0.9606239643149075	0.204180553806487	0.8888888888888888	0.1111111111111111	0.1111111111111111	0.	0.	0.1111111111111111
177	0.11058946601040501	0.7951882362456401	0.	0.7777777777777778	0.1111111111111111	0.	0.	0.1111111111111111
178	0.7647894008689526	0.380158691090806	0.6666666666666666	0.3333333333333333	0.1111111111111111	0.	0.	0.1111111111111111
179	0.5041046439509983	0.2884332196483289	0.4444444444444444	0.2222222222222222	0.1111111111111111	0.	0.	0.1111111111111111
180	0.1662987954843727	0.6743504273810706	0.1111111111111111	0.6666666666666666	0.1111111111111111	0.	0.	0.1111111111111111
181	0.8609898946258365	0.5609179943672692	0.7777777777777778	0.5555555555555556	0.1111111111111111	0.	0.	0.1111111111111111
182	0.5573751900010294	0.16559066824848973	0.5555555555555556	0.1111111111111111	0.1111111111111111	0.	0.	0.1111111111111111
183	0.8923866285244403	0.858938771821126	0.8888888888888888	0.7777777777777778	0.1111111111111111	0.	0.	0.1111111111111111
184	0.34149365290796485	0.36360192693198873	0.3333333333333333	0.3333333333333333	0.1111111111111111	0.	0.	0.1111111111111111
185	0.23296163358051	0.2553928271976343	0.2222222222222222	0.2222222222222222	0.1111111111111111	0.	0.	0.1111111111111111
186	0.47822318022352545	0.986128626425503	0.4444444444444444	0.8888888888888888	0.1111111111111111	0.	0.	0.1111111111111111
187	0.037834975389406084	0.5236962441601792	0.	0.4444444444444444	0.1111111111111111	0.	0.	0.1111111111111111
188	0.7168111089068739	0.013506507309856471	0.6666666666666666	0.	0.1111111111111111	0.	0.	0.1111111111111111
189	0.21188706241433022	0.4823947415611947	0.1111111111111111	0.4444444444444444	0.1111111111111111	0.	0.	0.1111111111111111
190	0.8046235193651138	0.0786995212326006	0.7777777777777778	0.	0.1111111111111111	0.	0.	0.1111111111111111
191	0.6208526794427404	0.9546808704447913	0.5555555555555556	0.8888888888888888	0.1111111111111111	0.	0.	0.1111111111111111
192	0.92908091910441	0.6613540625966566	0.8888888888888888	0.5555555555555556	0.1111111111111111	0.	0.	0.1111111111111111
193	0.39917287733673107	0.11953167419255072	0.3333333333333333	0.1111111111111111	0.1111111111111111	0.	0.	0.1111111111111111
194	0.2633531926254594	0.7738063985906882	0.2222222222222222	0.6666666666666666	0.1111111111111111	0.	0.	0.1111111111111111
195	0.5089579262460399	0.41083436520742883	0.4444444444444444	0.3333333333333333	0.1111111111111111	0.	0.	0.1111111111111111
196	0.0784931614703527	0.3054735660439822	0.	0.2222222222222222	0.1111111111111111	0.	0.	0.1111111111111111
197	0.7678345839886647	0.825343068006917	0.6666666666666666	0.7777777777777778	0.1111111111111111	0.	0.	0.1111111111111111
198	0.5688544142365516	0.621744995009802	0.5555555555555556	0.5555555555555556	0.1111111111111111	0.	0.	0.1111111111111111
199	0.18018966381168003	0.2127376894273309	0.1111111111111111	0.1111111111111111	0.1111111111111111	0.	0.	0.1111111111111111
200	0.8724999449715045	0.7213447798145063	0.7777777777777778	0.6666666666666666	0.1111111111111111	0.	0.	0.1111111111111111
201	0.23824850419823823	0.39179012462262086	0.2222222222222222	0.3333333333333333	0.1111111111111111	0.	0.	0.1111111111111111
202	0.9055886389460764	0.26780262947493905	0.8888888888888888	0.2222222222222222	0.1111111111111111	0.	0.	0.1111111111111111
203	0.3501621705230291	0.8026839033114054	0.3333333333333333	0.7777777777777778	0.1111111111111111	0.	0.	0.1111111111111111
204	0.7394236498421229	0.46129417710447074	0.6666666666666666	0.4444444444444444	0.1111111111111111	0.	0.	0.1111111111111111
205	0.45597431649172965	0.05137691362523679	0.4444444444444444	0.	0.1111111111111111	0.	0.	0.1111111111111111
206	0.05410068799949298	0.8957653295409476	0.	0.8888888888888888	0.1111111111111111	0.	0.	0.1111111111111111
207	0.8378871825749	0.33333450432629724	0.7777777777777778	0.3333333333333333	0.1111111111111111	0.	0.	0.1111111111111111
208	0.655907638379962	0.22839143474761692	0.5555555555555556	0.2222222222222222	0.1111111111111111	0.	0.	0.1111111111111111
209	0.13500705087042184	0.876025036455932	0.1111111111111111	0.7777777777777778	0.1111111111111111	0.	0.	0.1111111111111111
210	0.42668597048137363	0.5319706258488565	0.3333333333333333	0.4444444444444444	0.1111111111111111	0.	0.	0.1111111111111111
211	0.3138105618707567	0.03640788256468972	0.2222222222222222	0.	0.1111111111111111	0.	0.	0.1111111111111111
212	0.9774397459225068	0.9944289454792706	0.8888888888888888	0.8888888888888888	0.1111111111111111	0.	0.	0.1111111111111111
213	0.027976975855468163	0.5761192210289461	0.	0.5555555555555556	0.1111111111111111	0.	0.	0.1111111111111111
214	0.686360693914324	0.17626986424045324	0.6666666666666666	0.1111111111111111	0.1111111111111111	0.	0.	0.1111111111111111