1	0	0.0202515	0.0250766	0	0	0.333333	0	0	0.111111	0.	0.	0.1111111111111111	0.	0.	0.1111111111111111	0	0	0	0	0	0	0	0
1	0	0.153614	0.107599	0	0	0.333333	0	0	0.111111	0.1111111111111111	0.1111111111111111	0.	-0.1111111111111111	0.1111111111111111	0.	0	1	0	0	0	0	0	1
1	0	0.29641	0.0502066	0	0	0.333333	0	0	0.111111	0.2222222222222222	0.	0.1111111111111111	0.	0.	0.1111111111111111	0	2	0	0	0	0	0	2
1	0	0.235313	0.162886	0.333333	0.111111	0	0.111111	-0.333333	0	0.3333333333333333	0.1111111111111111	0.	0.1111111111111111	-0.1111111111111111	0.	0	2	0	1	0	0	1	0
1	0	0.333262	0.215824	0.333333	0.111111	0	0.111111	-0.333333	0	0.2222222222222222	0.2222222222222222	-0.1111111111111111	0.	0.	-0.1111111111111111	0	1	0	1	0	0	1	1
1	0	0.0437436	0.327733	0	0.222222	0.333333	0	0	0.111111	0.	0.2222222222222222	0.1111111111111111	0.	0.	0.1111111111111111	0	0	0	2	0	0	2	0
1	0	0.182699	0.258583	0	0.222222	0.333333	0	0	0.111111	0.1111111111111111	0.3333333333333333	0.	-0.1111111111111111	0.1111111111111111	0.	0	1	0	2	0	0	2	1
1	0	0.412207	0.299638	0.333333	0.333333	0	-0.333333	0.111111	0	0.3333333333333333	0.3333333333333333	0.	-0.1111111111111111	0.1111111111111111	0.	1	0	0	2	0	1	0	0
1	0	0.372359	0.134119	0.333333	0.333333	0	-0.333333	0.111111	0	0.4444444444444444	0.2222222222222222	-0.1111111111111111	0.	0.	-0.1111111111111111	1	0	0	1	0	1	0	1
1	0	0.545159	0.0694702	0.444444	0	0.111111	0	0	0.333333	0.4444444444444444	0.	0.1111111111111111	0.	0.	0.1111111111111111	1	1	0	0	0	1	1	0
1	0	0.486255	0.181853	0.444444	0	0.111111	0	0	0.333333	0.5555555555555556	0.1111111111111111	0.	0.1111111111111111	-0.1111111111111111	0.	1	1	0	1	0	1	1	1
1	0	0.627931	0.276043	0.555556	0.333333	0	-0.333333	0.111111	0	0.5555555555555556	0.3333333333333333	0.	-0.1111111111111111	0.1111111111111111	0.	1	2	0	2	0	1	2	0
1	0	0.599117	0.231902	0.555556	0.333333	0	-0.333333	0.111111	0	0.6666666666666666	0.2222222222222222	-0.1111111111111111	0.	0.	-0.1111111111111111	1	2	0	1	0	1	2	1
1	0	0.739873	0.0890557	0.666667	0	0.333333	0	0	0.111111	0.6666666666666666	0.	0.1111111111111111	0.	0.	0.1111111111111111	2	0	0	0	0	2	0	0
1	0	0.79712	0.0101942	0.666667	0	0.333333	0	0	0.111111	0.7777777777777778	0.1111111111111111	0.	-0.1111111111111111	0.1111111111111111	0.	2	1	0	0	0	2	0	1
1	0	0.927799	0.122397	1	0.111111	0	0.111111	-0.333333	0	1.	0.1111111111111111	0.	0.1111111111111111	-0.1111111111111111	0.	2	2	0	1	0	2	1	0
1	0	0.856292	0.196157	1	0.111111	0	0.111111	-0.333333	0	0.8888888888888888	0.2222222222222222	-0.1111111111111111	0.	0.	-0.1111111111111111	2	1	0	1	0	2	1	1
1	0	0.98446	0.247713	0.666667	0.222222	0.333333	0	0	0.111111	0.6666666666666666	0.2222222222222222	0.1111111111111111	0.	0.	0.1111111111111111	2	0	0	2	0	2	2	0
1	0	0.886821	0.313789	0.666667	0.222222	0.333333	0	0	0.111111	0.7777777777777778	0.3333333333333333	0.	-0.1111111111111111	0.1111111111111111	0.	2	1	0	2	0	2	2	1
1	0	0.907454	0.645799	1	0.333333	0	0.333333	-0.111111	0	1.	0.3333333333333333	0.	0.1111111111111111	-0.1111111111111111	0.	2	2	1	0	1	0	0	0
1	0	0.959935	0.443656	1	0.333333	0	0.333333	-0.111111	0	0.8888888888888888	0.4444444444444444	0.1111111111111111	0.	0.	0.1111111111111111	2	2	1	1	1	0	0	1
1	0	0.777864	0.571717	0.888889	0.666667	-0.111111	0	0	-0.333333	0.8888888888888888	0.6666666666666666	-0.1111111111111111	0.	0.	-0.1111111111111111	2	1	1	2	1	0	1	0
1	0	0.822597	0.512298	0.888889	0.666667	-0.111111	0	0	-0.333333	0.7777777777777778	0.5555555555555556	0.	-0.1111111111111111	0.1111111111111111	0.	2	1	1	1	1	0	1	1
1	0	0.717908	0.346168	0.777778	0.333333	0	0.333333	-0.111111	0	0.7777777777777778	0.3333333333333333	0.	0.1111111111111111	-0.1111111111111111	0.	2	0	1	0	1	0	2	0
1	0	0.689454	0.476253	0.777778	0.333333	0	0.333333	-0.111111	0	0.6666666666666666	0.4444444444444444	0.1111111111111111	0.	0.	0.1111111111111111	2	0	1	1	1	0	2	1
1	0	0.577598	0.587872	0.666667	0.666667	-0.333333	0	0	-0.111111	0.6666666666666666	0.6666666666666666	-0.1111111111111111	0.	0.	-0.1111111111111111	1	2	1	2	1	1	0	0
1	0	0.387785	0.60665	0.666667	0.666667	-0.333333	0	0	-0.111111	0.5555555555555556	0.5555555555555556	0.	0.1111111111111111	-0.1111111111111111	0.	1	1	1	2	1	1	0	1
1	0	0.438245	0.528622	0.333333	0.555556	0	-0.111111	0.333333	0	0.3333333333333333	0.5555555555555556	0.	-0.1111111111111111	0.1111111111111111	0.	1	0	1	1	1	1	1	0
1	0	0.460745	0.457084	0.333333	0.555556	0	-0.111111	0.333333	0	0.4444444444444444	0.4444444444444444	0.1111111111111111	0.	0.	0.1111111111111111	1	1	1	1	1	1	1	1
1	0	0.65176	0.388381	0.666667	0.444444	-0.333333	0	0	-0.111111	0.6666666666666666	0.4444444444444444	-0.1111111111111111	0.	0.	-0.1111111111111111	1	2	1	0	1	1	2	0
1	0	0.518508	0.431951	0.666667	0.444444	-0.333333	0	0	-0.111111	0.5555555555555556	0.3333333333333333	0.	0.1111111111111111	-0.1111111111111111	0.	1	1	1	0	1	1	2	1
1	0	0.269151	0.412405	0.333333	0.333333	0	0.333333	-0.111111	0	0.3333333333333333	0.3333333333333333	0.	0.1111111111111111	-0.1111111111111111	0.	0	2	1	0	1	2	0	0
1	0	0.317451	0.661778	0.333333	0.333333	0	0.333333	-0.111111	0	0.2222222222222222	0.4444444444444444	0.1111111111111111	0.	0.	0.1111111111111111	0	2	1	1	1	2	0	1
1	0	0.201836	0.629816	0.222222	0.666667	-0.111111	0	0	-0.333333	0.2222222222222222	0.6666666666666666	-0.1111111111111111	0.	0.	-0.1111111111111111	0	1	1	2	1	2	1	0
1	0	0.134495	0.493276	0.222222	0.666667	-0.111111	0	0	-0.333333	0.1111111111111111	0.5555555555555556	0.	-0.1111111111111111	0.1111111111111111	0.	0	1	1	1	1	2	1	1
1	0	0.100676	0.370469	0.111111	0.333333	0	0.333333	-0.111111	0	0.1111111111111111	0.3333333333333333	0.	0.1111111111111111	-0.1111111111111111	0.	0	0	1	0	1	2	2	0
1	0	0.0622112	0.552778	0.111111	0.333333	0	0.333333	-0.111111	0	0.	0.4444444444444444	0.1111111111111111	0.	0.	0.1111111111111111	0	0	1	1	1	2	2	1
1	0	0.0798779	0.701862	0	0.666667	0.333333	0	0	0.111111	0.	0.6666666666666666	0.1111111111111111	0.	0.	0.1111111111111111	0	0	2	0	2	0	0	0
1	0	0.220663	0.737758	0	0.666667	0.333333	0	0	0.111111	0.1111111111111111	0.7777777777777778	0.	-0.1111111111111111	0.1111111111111111	0.	0	1	2	0	2	0	0	1
1	0	0.255485	0.840811	0.333333	0.777778	0	0.111111	-0.333333	0	0.3333333333333333	0.7777777777777778	0.	0.1111111111111111	-0.1111111111111111	0.	0	2	2	1	2	0	1	0
1	0	0.118276	0.794157	0.333333	0.777778	0	0.111111	-0.333333	0	0.2222222222222222	0.8888888888888888	-0.1111111111111111	0.	0.	-0.1111111111111111	0	1	2	1	2	0	1	1
1	0	0.284939	0.979494	0	0.888889	0.333333	0	0	0.111111	0.	0.8888888888888888	0.1111111111111111	0.	0.	0.1111111111111111	0	0	2	2	2	0	2	0
1	0	0.00937823	0.929727	0	0.888889	0.333333	0	0	0.111111	0.1111111111111111	1.	0.	-0.1111111111111111	0.1111111111111111	0.	0	1	2	2	2	0	2	1
1	0	0.352323	0.904503	0.333333	1	0	-0.333333	0.111111	0	0.3333333333333333	1.	0.	-0.1111111111111111	0.1111111111111111	0.	1	0	2	2	2	1	0	0
1	0	0.426499	0.866963	0.333333	1	0	-0.333333	0.111111	0	0.4444444444444444	0.8888888888888888	-0.1111111111111111	0.	0.	-0.1111111111111111	1	0	2	1	2	1	0	1
1	0	0.511527	0.999998	0.444444	0.666667	0.111111	0	0	0.333333	0.4444444444444444	0.6666666666666666	0.1111111111111111	0.	0.	0.1111111111111111	1	1	2	0	2	1	1	0
1	0	0.502235	0.816292	0.444444	0.666667	0.111111	0	0	0.333333	0.5555555555555556	0.7777777777777778	0.	0.1111111111111111	-0.1111111111111111	0.	1	1	2	1	2	1	1	1
1	0	0.612529	0.9579	0.555556	1	0	-0.333333	0.111111	0	0.5555555555555556	1.	0.	-0.1111111111111111	0.1111111111111111	0.	1	2	2	2	2	1	2	0
1	0	0.560387	0.757908	0.555556	1	0	-0.333333	0.111111	0	0.6666666666666666	0.8888888888888888	-0.1111111111111111	0.	0.	-0.1111111111111111	1	2	2	1	2	1	2	1
1	0	0.667736	0.68296	0.666667	0.666667	0.333333	0	0	0.111111	0.6666666666666666	0.6666666666666666	0.1111111111111111	0.	0.	0.1111111111111111	2	0	2	0	2	2	0	0
1	0	0.840355	0.721103	0.666667	0.666667	0.333333	0	0	0.111111	0.7777777777777778	0.7777777777777778	0.	-0.1111111111111111	0.1111111111111111	0.	2	1	2	0	2	2	0	1
1	0	0.943999	0.851058	1	0.777778	0	0.111111	-0.333333	0	1.	0.7777777777777778	0.	0.1111111111111111	-0.1111111111111111	0.	2	2	2	1	2	2	1	0
1	0	0.758709	0.777891	1	0.777778	0	0.111111	-0.333333	0	0.8888888888888888	0.8888888888888888	-0.1111111111111111	0.	0.	-0.1111111111111111	2	1	2	1	2	2	1	1
1	0	0.872157	0.9428	0.666667	0.888889	0.333333	0	0	0.111111	0.6666666666666666	0.8888888888888888	0.1111111111111111	0.	0.	0.1111111111111111	2	0	2	2	2	2	2	0
1	0	0.703147	0.889045	0.666667	0.888889	0.333333	0	0	0.111111	0.7777777777777778	1.	0.	-0.1111111111111111	0.1111111111111111	0.	2	1	2	2	2	2	2	1
