0	0.0267324	0.00313107	0	0	0.111111	0 	0 	0.111111	
192	0.0445298	0.048391	0	0	0.111111	0 	0 	0.111111	
141	0.0779546	0.0876639	0	0	0.111111	0 	0 	0.111111	
131	0.139022	0.0677608	0.111111	0.111111	0.111111	0 	0 	-0.111111	
80	0.172348	0.100863	0.111111	0.111111	0.111111	0 	0 	-0.111111	
182	0.207723	0.0265172	0.111111	0.111111	0.111111	0 	0 	-0.111111	
91	0.27819	0.0207914	0.222222	0	0.111111	0 	0 	0.111111	
40	0.308718	0.0536356	0.222222	0	0.111111	0 	0 	0.111111	
200	0.322213	0.124847	0.333333	0.111111	-0.111111	0 	0 	0.111111	
17	0.262513	0.185585	0.333333	0.111111	-0.111111	0 	0 	0.111111	
149	0.235002	0.153935	0.333333	0.111111	-0.111111	0 	0 	0.111111	
105	0.208012	0.172918	0.222222	0.222222	-0.111111	0 	0 	-0.111111	
45	0.221862	0.20289	0.222222	0.222222	-0.111111	0 	0 	-0.111111	
58	0.110895	0.150163	0.111111	0.111111	-0.111111	0 	0 	0.111111	
109	0.0752901	0.123383	0.111111	0.111111	-0.111111	0 	0 	0.111111	
169	0.0221118	0.209977	0.111111	0.111111	-0.111111	0 	0 	0.111111	
218	0.112301	0.238609	0	0.222222	0.111111	0 	0 	0.111111	
86	0.0164755	0.276702	0	0.222222	0.111111	0 	0 	0.111111	
35	0.0463856	0.308314	0	0.222222	0.111111	0 	0 	0.111111	
214	0.132752	0.328163	0.111111	0.333333	0.111111	0 	0 	-0.111111	
154	0.148823	0.231217	0.111111	0.333333	0.111111	0 	0 	-0.111111	
22	0.186467	0.256612	0.111111	0.333333	0.111111	0 	0 	-0.111111	
63	0.265736	0.271403	0.222222	0.222222	0.111111	0 	0 	0.111111	
174	0.297609	0.28806	0.222222	0.222222	0.111111	0 	0 	0.111111	
123	0.321474	0.327266	0.222222	0.222222	0.111111	0 	0 	0.111111	
97	0.386831	0.242798	0.333333	0.333333	0.111111	0 	0 	-0.111111	
37	0.422273	0.279295	0.333333	0.333333	0.111111	0 	0 	-0.111111	
120	0.444356	0.197654	0.444444	0.222222	-0.111111	0 	0 	-0.111111	
171	0.430493	0.169874	0.444444	0.222222	-0.111111	0 	0 	-0.111111	
69	0.35719	0.138672	0.444444	0.222222	-0.111111	0 	0 	-0.111111	
146	0.363018	0.0816256	0.333333	0.111111	0.111111	0 	0 	-0.111111	
14	0.37037	0.0740741	0.333333	0.111111	0.111111	0 	0 	-0.111111	
206	0.415638	0.00411523	0.333333	0.111111	0.111111	0 	0 	-0.111111	
115	0.512781	0.0324089	0.444444	0	0.111111	0 	0 	0.111111	
55	0.546408	0.0664473	0.444444	0	0.111111	0 	0 	0.111111	
166	0.472448	0.104071	0.444444	0	0.111111	0 	0 	0.111111	
32	0.555543	0.162561	0.555556	0.111111	-0.111111	0 	0 	0.111111	
83	0.513555	0.132921	0.555556	0.111111	-0.111111	0 	0 	0.111111	
6	0.463988	0.223055	0.444444	0.222222	0.111111	0 	0 	0.111111	
189	0.489533	0.267021	0.444444	0.222222	0.111111	0 	0 	0.111111	
138	0.52042	0.304064	0.444444	0.222222	0.111111	0 	0 	0.111111	
128	0.589409	0.29394	0.555556	0.333333	0.111111	0 	0 	-0.111111	
77	0.617148	0.3192	0.555556	0.333333	0.111111	0 	0 	-0.111111	
188	0.661807	0.249669	0.555556	0.333333	0.111111	0 	0 	-0.111111	
211	0.564461	0.190207	0.666667	0.222222	-0.111111	0 	0 	-0.111111	
19	0.637508	0.207854	0.666667	0.222222	-0.111111	0 	0 	-0.111111	
160	0.597906	0.11866	0.666667	0.222222	-0.111111	0 	0 	-0.111111	
51	0.558114	0.0236394	0.555556	0.111111	0.111111	0 	0 	-0.111111	
102	0.651392	0.0930025	0.555556	0.111111	0.111111	0 	0 	-0.111111	
157	0.707803	0.0323799	0.666667	0	0.111111	0 	0 	0.111111	
25	0.747555	0.0373415	0.666667	0	0.111111	0 	0 	0.111111	
208	0.696958	0.0552192	0.666667	0	0.111111	0 	0 	0.111111	
66	0.793677	0.0272825	0.777778	0.111111	0.111111	0 	0 	-0.111111	
177	0.847962	0.0671986	0.777778	0.111111	0.111111	0 	0 	-0.111111	
117	0.883664	0.103343	0.777778	0.111111	0.111111	0 	0 	-0.111111	
89	0.931175	0.019645	0.888889	0	0.111111	0 	0 	0.111111	
29	0.933876	0.0835888	0.888889	0	0.111111	0 	0 	0.111111	
135	0.967456	0.198539	1	0.111111	-0.111111	0 	0 	0.111111	
195	0.991017	0.151833	1	0.111111	-0.111111	0 	0 	0.111111	
3	0.888889	0.111111	1	0.111111	-0.111111	0 	0 	0.111111	
43	0.86084	0.170417	0.888889	0.222222	-0.111111	0 	0 	-0.111111	
94	0.829268	0.124128	0.888889	0.222222	-0.111111	0 	0 	-0.111111	
185	0.776681	0.148873	0.777778	0.111111	-0.111111	0 	0 	0.111111	
74	0.732324	0.209841	0.777778	0.111111	-0.111111	0 	0 	0.111111	
134	0.695512	0.177632	0.777778	0.111111	-0.111111	0 	0 	0.111111	
48	0.706636	0.236396	0.666667	0.222222	0.111111	0 	0 	0.111111	
99	0.763394	0.315663	0.666667	0.222222	0.111111	0 	0 	0.111111	
152	0.797347	0.273692	0.777778	0.333333	0.111111	0 	0 	-0.111111	
11	0.805531	0.282092	0.777778	0.333333	0.111111	0 	0 	-0.111111	
203	0.859365	0.225041	0.777778	0.333333	0.111111	0 	0 	-0.111111	
112	0.9443	0.252815	0.888889	0.222222	0.111111	0 	0 	0.111111	
61	0.986851	0.283564	0.888889	0.222222	0.111111	0 	0 	0.111111	
163	0.91915	0.318502	0.888889	0.222222	0.111111	0 	0 	0.111111	
104	0.964171	0.375906	1	0.333333	-0.111111	0 	0 	0.111111	
53	0.901215	0.348758	1	0.333333	-0.111111	0 	0 	0.111111	
159	0.904226	0.459808	0.888889	0.444444	0.111111	0 	0 	0.111111	
18	0.963483	0.486446	0.888889	0.444444	0.111111	0 	0 	0.111111	
210	0.918959	0.455251	0.888889	0.444444	0.111111	0 	0 	0.111111	
187	0.99579	0.589957	1	0.555556	-0.111111	0 	0 	0.111111	
76	0.986681	0.582198	1	0.555556	-0.111111	0 	0 	0.111111	
127	0.919351	0.629589	1	0.555556	-0.111111	0 	0 	0.111111	
140	0.858145	0.634849	0.888889	0.666667	-0.111111	0 	0 	-0.111111	
191	0.819932	0.594741	0.888889	0.666667	-0.111111	0 	0 	-0.111111	
8	0.873066	0.637695	0.888889	0.666667	-0.111111	0 	0 	-0.111111	
82	0.794789	0.485747	0.777778	0.555556	0.111111	0 	0 	-0.111111	
31	0.804841	0.51287	0.777778	0.555556	0.111111	0 	0 	-0.111111	
165	0.874635	0.426557	0.888889	0.444444	-0.111111	0 	0 	-0.111111	
54	0.84611	0.426982	0.888889	0.444444	-0.111111	0 	0 	-0.111111	
114	0.845507	0.369699	0.888889	0.444444	-0.111111	0 	0 	-0.111111	
205	0.749104	0.333871	0.777778	0.333333	-0.111111	0 	0 	0.111111	
13	0.703099	0.407828	0.777778	0.333333	-0.111111	0 	0 	0.111111	
145	0.669832	0.390641	0.777778	0.333333	-0.111111	0 	0 	0.111111	
71	0.696452	0.478176	0.666667	0.444444	0.111111	0 	0 	0.111111	
173	0.736626	0.510288	0.666667	0.444444	0.111111	0 	0 	0.111111	
122	0.774308	0.552798	0.666667	0.444444	0.111111	0 	0 	0.111111	
36	0.763924	0.555759	0.777778	0.555556	-0.111111	0 	0 	0.111111	
96	0.718652	0.580075	0.777778	0.555556	-0.111111	0 	0 	0.111111	
125	0.666	0.656707	0.666667	0.666667	-0.111111	0 	0 	-0.111111	
176	0.625113	0.618584	0.666667	0.666667	-0.111111	0 	0 	-0.111111	
65	0.581196	0.581332	0.666667	0.666667	-0.111111	0 	0 	-0.111111	
21	0.523381	0.591315	0.555556	0.555556	-0.111111	0 	0 	0.111111	
153	0.489123	0.559295	0.555556	0.555556	-0.111111	0 	0 	0.111111	
213	0.450985	0.634877	0.555556	0.555556	-0.111111	0 	0 	0.111111	
34	0.399403	0.648836	0.444444	0.666667	-0.111111	0 	0 	-0.111111	
85	0.344172	0.608493	0.444444	0.666667	-0.111111	0 	0 	-0.111111	
217	0.428879	0.576771	0.444444	0.666667	-0.111111	0 	0 	-0.111111	
168	0.351309	0.53846	0.333333	0.555556	0.111111	0 	0 	-0.111111	
108	0.396207	0.47539	0.333333	0.555556	0.111111	0 	0 	-0.111111	
57	0.435524	0.498293	0.333333	0.555556	0.111111	0 	0 	-0.111111	
47	0.458811	0.452431	0.444444	0.444444	0.111111	0 	0 	0.111111	
107	0.536126	0.541502	0.444444	0.444444	0.111111	0 	0 	0.111111	
148	0.570465	0.490467	0.555556	0.555556	0.111111	0 	0 	-0.111111	
16	0.595822	0.521239	0.555556	0.555556	0.111111	0 	0 	-0.111111	
199	0.639293	0.446754	0.555556	0.555556	0.111111	0 	0 	-0.111111	
39	0.638819	0.387276	0.666667	0.444444	-0.111111	0 	0 	-0.111111	
90	0.611761	0.351778	0.666667	0.444444	-0.111111	0 	0 	-0.111111	
181	0.555025	0.376466	0.555556	0.333333	-0.111111	0 	0 	0.111111	
79	0.506957	0.431561	0.555556	0.333333	-0.111111	0 	0 	0.111111	
130	0.473028	0.404564	0.555556	0.333333	-0.111111	0 	0 	0.111111	
143	0.416532	0.415737	0.444444	0.444444	-0.111111	0 	0 	-0.111111	
194	0.378601	0.374486	0.444444	0.444444	-0.111111	0 	0 	-0.111111	
2	0.341344	0.333392	0.444444	0.444444	-0.111111	0 	0 	-0.111111	
28	0.26935	0.423323	0.333333	0.333333	-0.111111	0 	0 	0.111111	
88	0.306905	0.367536	0.333333	0.333333	-0.111111	0 	0 	0.111111	
5	0.239748	0.450103	0.222222	0.444444	0.111111	0 	0 	0.111111	
197	0.249711	0.506647	0.222222	0.444444	0.111111	0 	0 	0.111111	
137	0.299697	0.524541	0.222222	0.444444	0.111111	0 	0 	0.111111	
60	0.305528	0.635244	0.333333	0.555556	-0.111111	0 	0 	0.111111	
111	0.287821	0.590331	0.333333	0.555556	-0.111111	0 	0 	0.111111	
162	0.25009	0.65382	0.333333	0.555556	-0.111111	0 	0 	0.111111	
10	0.149799	0.630857	0.222222	0.666667	-0.111111	0 	0 	-0.111111	
151	0.116134	0.601652	0.222222	0.666667	-0.111111	0 	0 	-0.111111	
202	0.19429	0.564564	0.222222	0.666667	-0.111111	0 	0 	-0.111111	
93	0.161143	0.464793	0.111111	0.555556	0.111111	0 	0 	-0.111111	
42	0.19794	0.49251	0.111111	0.555556	0.111111	0 	0 	-0.111111	
119	0.179335	0.43795	0.222222	0.444444	-0.111111	0 	0 	-0.111111	
179	0.195838	0.388638	0.222222	0.444444	-0.111111	0 	0 	-0.111111	
68	0.136317	0.354114	0.222222	0.444444	-0.111111	0 	0 	-0.111111	
24	0.092129	0.389312	0.111111	0.333333	-0.111111	0 	0 	0.111111	
156	0.0694858	0.337327	0.111111	0.333333	-0.111111	0 	0 	0.111111	
207	0.0146381	0.416319	0.111111	0.333333	-0.111111	0 	0 	0.111111	
184	0.0973046	0.474528	0	0.444444	0.111111	0 	0 	0.111111	
133	0.0290693	0.52381	0	0.444444	0.111111	0 	0 	0.111111	
73	0.0624349	0.539937	0	0.444444	0.111111	0 	0 	0.111111	
101	0.0917454	0.652841	0.111111	0.555556	-0.111111	0 	0 	0.111111	
50	0.0105105	0.56971	0.111111	0.555556	-0.111111	0 	0 	0.111111	
204	0.0841453	0.674613	0	0.666667	0.111111	0 	0 	0.111111	
144	0.0270861	0.731286	0	0.666667	0.111111	0 	0 	0.111111	
12	0.0418609	0.74922	0	0.666667	0.111111	0 	0 	0.111111	
167	0.139008	0.762025	0.111111	0.777778	0.111111	0 	0 	-0.111111	
116	0.174115	0.699602	0.111111	0.777778	0.111111	0 	0 	-0.111111	
56	0.211749	0.721748	0.111111	0.777778	0.111111	0 	0 	-0.111111	
52	0.22248	0.689999	0.222222	0.666667	0.111111	0 	0 	0.111111	
103	0.314288	0.760812	0.222222	0.666667	0.111111	0 	0 	0.111111	
20	0.291275	0.805467	0.333333	0.777778	-0.111111	0 	0 	0.111111	
161	0.263728	0.785911	0.333333	0.777778	-0.111111	0 	0 	0.111111	
212	0.227378	0.857649	0.333333	0.777778	-0.111111	0 	0 	0.111111	
30	0.163872	0.861814	0.222222	0.888889	-0.111111	0 	0 	-0.111111	
81	0.123584	0.84039	0.222222	0.888889	-0.111111	0 	0 	-0.111111	
121	0.0968327	0.874158	0.111111	0.777778	-0.111111	0 	0 	0.111111	
172	0.0700454	0.843622	0.111111	0.777778	-0.111111	0 	0 	0.111111	
70	0.0107662	0.794537	0.111111	0.777778	-0.111111	0 	0 	0.111111	
98	0.0572082	0.925447	0	0.888889	0.111111	0 	0 	0.111111	
38	0.028316	0.971351	0	0.888889	0.111111	0 	0 	0.111111	
7	0.125923	0.89138	0.111111	1	0.111111	0 	0 	-0.111111	
190	0.154598	0.927128	0.111111	1	0.111111	0 	0 	-0.111111	
139	0.19496	0.960268	0.111111	1	0.111111	0 	0 	-0.111111	
186	0.330358	0.913611	0.222222	0.888889	0.111111	0 	0 	0.111111	
126	0.23619	0.98045	0.222222	0.888889	0.111111	0 	0 	0.111111	
75	0.279646	0.993599	0.222222	0.888889	0.111111	0 	0 	0.111111	
49	0.346753	0.889478	0.333333	1	0.111111	0 	0 	-0.111111	
100	0.347233	0.987807	0.333333	1	0.111111	0 	0 	-0.111111	
72	0.402269	0.875425	0.444444	0.888889	-0.111111	0 	0 	-0.111111	
132	0.366653	0.849892	0.444444	0.888889	-0.111111	0 	0 	-0.111111	
183	0.430075	0.81923	0.444444	0.888889	-0.111111	0 	0 	-0.111111	
209	0.347768	0.763917	0.333333	0.777778	0.111111	0 	0 	-0.111111	
158	0.375939	0.668389	0.333333	0.777778	0.111111	0 	0 	-0.111111	
26	0.407407	0.703704	0.333333	0.777778	0.111111	0 	0 	-0.111111	
67	0.472471	0.705541	0.444444	0.666667	0.111111	0 	0 	0.111111	
178	0.513927	0.736741	0.444444	0.666667	0.111111	0 	0 	0.111111	
118	0.541756	0.77737	0.444444	0.666667	0.111111	0 	0 	0.111111	
44	0.51338	0.872988	0.555556	0.777778	-0.111111	0 	0 	0.111111	
95	0.496312	0.800515	0.555556	0.777778	-0.111111	0 	0 	0.111111	
201	0.469318	0.923803	0.444444	0.888889	0.111111	0 	0 	0.111111	
150	0.448591	0.957122	0.444444	0.888889	0.111111	0 	0 	0.111111	
9	0.487774	0.958515	0.444444	0.888889	0.111111	0 	0 	0.111111	
164	0.569792	0.962689	0.555556	1	0.111111	0 	0 	-0.111111	
113	0.621367	0.919957	0.555556	1	0.111111	0 	0 	-0.111111	
62	0.651928	0.957855	0.555556	1	0.111111	0 	0 	-0.111111	
136	0.621229	0.852738	0.666667	0.888889	-0.111111	0 	0 	-0.111111	
196	0.59844	0.819351	0.666667	0.888889	-0.111111	0 	0 	-0.111111	
4	0.550887	0.778306	0.666667	0.888889	-0.111111	0 	0 	-0.111111	
87	0.569522	0.728315	0.555556	0.777778	0.111111	0 	0 	-0.111111	
27	0.605597	0.756489	0.555556	0.777778	0.111111	0 	0 	-0.111111	
219	0.653484	0.677713	0.555556	0.777778	0.111111	0 	0 	-0.111111	
1	0.694092	0.667286	0.666667	0.666667	0.111111	0 	0 	0.111111	
193	0.703272	0.698179	0.666667	0.666667	0.111111	0 	0 	0.111111	
142	0.743594	0.744307	0.666667	0.666667	0.111111	0 	0 	0.111111	
129	0.805935	0.714105	0.777778	0.777778	0.111111	0 	0 	-0.111111	
78	0.842743	0.766449	0.777778	0.777778	0.111111	0 	0 	-0.111111	
180	0.885983	0.70542	0.777778	0.777778	0.111111	0 	0 	-0.111111	
92	0.945195	0.692902	0.888889	0.666667	0.111111	0 	0 	0.111111	
41	0.972005	0.717185	0.888889	0.666667	0.111111	0 	0 	0.111111	
198	0.957286	0.791911	1	0.777778	-0.111111	0 	0 	0.111111	
15	0.916625	0.853527	1	0.777778	-0.111111	0 	0 	0.111111	
147	0.893364	0.819241	1	0.777778	-0.111111	0 	0 	0.111111	
106	0.868126	0.868192	0.888889	0.888889	-0.111111	0 	0 	-0.111111	
46	0.784987	0.790186	0.888889	0.888889	-0.111111	0 	0 	-0.111111	
59	0.763908	0.821729	0.777778	0.777778	-0.111111	0 	0 	0.111111	
110	0.740062	0.8199	0.777778	0.777778	-0.111111	0 	0 	0.111111	
170	0.691546	0.876365	0.777778	0.777778	-0.111111	0 	0 	0.111111	
216	0.76493	0.907506	0.666667	0.888889	0.111111	0 	0 	0.111111	
84	0.675484	0.944725	0.666667	0.888889	0.111111	0 	0 	0.111111	
33	0.714774	0.97766	0.666667	0.888889	0.111111	0 	0 	0.111111	
215	0.820145	0.976185	0.777778	1	0.111111	0 	0 	-0.111111	
155	0.819677	0.88983	0.777778	1	0.111111	0 	0 	-0.111111	
23	0.855385	0.926939	0.777778	1	0.111111	0 	0 	-0.111111	
64	0.934254	0.893145	0.888889	0.888889	0.111111	0 	0 	0.111111	
175	0.963998	0.938272	0.888889	0.888889	0.111111	0 	0 	0.111111	
124	0.990613	0.998198	0.888889	0.888889	0.111111	0 	0 	0.111111	
