0	0.0468729	0.0275502	0	0	0.111111	0 	0 	0.111111	
192	0.0300593	0.0529093	0	0	0.111111	0 	0 	0.111111	
141	0.0996239	0.0803589	0	0	0.111111	0 	0 	0.111111	
131	0.13907	0.10418	0.111111	0.111111	0.111111	0 	0 	-0.111111	
80	0.17554	0.0991976	0.111111	0.111111	0.111111	0 	0 	-0.111111	
182	0.208618	0.0260283	0.111111	0.111111	0.111111	0 	0 	-0.111111	
91	0.279346	0.0167245	0.222222	0	0.111111	0 	0 	0.111111	
40	0.264804	0.0418343	0.222222	0	0.111111	0 	0 	0.111111	
200	0.327547	0.139181	0.333333	0.111111	-0.111111	0 	0 	0.111111	
17	0.259082	0.185903	0.333333	0.111111	-0.111111	0 	0 	0.111111	
149	0.228306	0.162325	0.333333	0.111111	-0.111111	0 	0 	0.111111	
105	0.194364	0.204023	0.222222	0.222222	-0.111111	0 	0 	-0.111111	
45	0.124822	0.124028	0.222222	0.222222	-0.111111	0 	0 	-0.111111	
58	0.0969355	0.216249	0.111111	0.111111	-0.111111	0 	0 	0.111111	
109	0.0652772	0.151624	0.111111	0.111111	-0.111111	0 	0 	0.111111	
169	0.00955247	0.214602	0.111111	0.111111	-0.111111	0 	0 	0.111111	
86	0.0215862	0.291808	0	0.222222	0.111111	0 	0 	0.111111	
35	0.0474648	0.312901	0	0.222222	0.111111	0 	0 	0.111111	
154	0.147276	0.232483	0.111111	0.333333	0.111111	0 	0 	-0.111111	
22	0.183735	0.259832	0.111111	0.333333	0.111111	0 	0 	-0.111111	
63	0.270391	0.244267	0.222222	0.222222	0.111111	0 	0 	0.111111	
174	0.292049	0.287659	0.222222	0.222222	0.111111	0 	0 	0.111111	
123	0.323091	0.329052	0.222222	0.222222	0.111111	0 	0 	0.111111	
97	0.381643	0.243805	0.333333	0.333333	0.111111	0 	0 	-0.111111	
37	0.421172	0.271143	0.333333	0.333333	0.111111	0 	0 	-0.111111	
120	0.434657	0.216789	0.444444	0.222222	-0.111111	0 	0 	-0.111111	
171	0.3907	0.180283	0.444444	0.222222	-0.111111	0 	0 	-0.111111	
69	0.360347	0.13588	0.444444	0.222222	-0.111111	0 	0 	-0.111111	
146	0.347266	0.0598199	0.333333	0.111111	0.111111	0 	0 	-0.111111	
14	0.362944	0.0751202	0.333333	0.111111	0.111111	0 	0 	-0.111111	
206	0.420614	0.0058379	0.333333	0.111111	0.111111	0 	0 	-0.111111	
115	0.501987	0.0334182	0.444444	0	0.111111	0 	0 	0.111111	
55	0.542534	0.0657971	0.444444	0	0.111111	0 	0 	0.111111	
166	0.473038	0.111093	0.444444	0	0.111111	0 	0 	0.111111	
32	0.555247	0.15892	0.555556	0.111111	-0.111111	0 	0 	0.111111	
83	0.460905	0.168724	0.555556	0.111111	-0.111111	0 	0 	0.111111	
6	0.445079	0.281167	0.444444	0.222222	0.111111	0 	0 	0.111111	
189	0.494631	0.259972	0.444444	0.222222	0.111111	0 	0 	0.111111	
138	0.527276	0.306812	0.444444	0.222222	0.111111	0 	0 	0.111111	
128	0.576831	0.290498	0.555556	0.333333	0.111111	0 	0 	-0.111111	
77	0.616495	0.321944	0.555556	0.333333	0.111111	0 	0 	-0.111111	
188	0.660916	0.250544	0.555556	0.333333	0.111111	0 	0 	-0.111111	
211	0.561382	0.18844	0.666667	0.222222	-0.111111	0 	0 	-0.111111	
19	0.626778	0.146331	0.666667	0.222222	-0.111111	0 	0 	-0.111111	
160	0.593977	0.12018	0.666667	0.222222	-0.111111	0 	0 	-0.111111	
51	0.583698	0.0470779	0.555556	0.111111	0.111111	0 	0 	-0.111111	
102	0.639431	0.0983041	0.555556	0.111111	0.111111	0 	0 	-0.111111	
157	0.703809	0.00655415	0.666667	0	0.111111	0 	0 	0.111111	
25	0.745075	0.039299	0.666667	0	0.111111	0 	0 	0.111111	
208	0.695995	0.0697466	0.666667	0	0.111111	0 	0 	0.111111	
66	0.797565	0.0217375	0.777778	0.111111	0.111111	0 	0 	-0.111111	
177	0.849991	0.0641226	0.777778	0.111111	0.111111	0 	0 	-0.111111	
117	0.883749	0.103054	0.777778	0.111111	0.111111	0 	0 	-0.111111	
89	0.922998	0.0262754	0.888889	0	0.111111	0 	0 	0.111111	
29	0.937897	0.0837314	0.888889	0	0.111111	0 	0 	0.111111	
135	0.9715	0.201375	1	0.111111	-0.111111	0 	0 	0.111111	
195	0.977486	0.149764	1	0.111111	-0.111111	0 	0 	0.111111	
3	0.888889	0.111111	1	0.111111	-0.111111	0 	0 	0.111111	
43	0.856376	0.156129	0.888889	0.222222	-0.111111	0 	0 	-0.111111	
94	0.846557	0.202189	0.888889	0.222222	-0.111111	0 	0 	-0.111111	
185	0.762581	0.12773	0.777778	0.111111	-0.111111	0 	0 	0.111111	
74	0.723453	0.209703	0.777778	0.111111	-0.111111	0 	0 	0.111111	
134	0.696605	0.177051	0.777778	0.111111	-0.111111	0 	0 	0.111111	
48	0.704936	0.23668	0.666667	0.222222	0.111111	0 	0 	0.111111	
99	0.761865	0.317598	0.666667	0.222222	0.111111	0 	0 	0.111111	
152	0.791079	0.274495	0.777778	0.333333	0.111111	0 	0 	-0.111111	
11	0.812145	0.29393	0.777778	0.333333	0.111111	0 	0 	-0.111111	
203	0.862955	0.226921	0.777778	0.333333	0.111111	0 	0 	-0.111111	
112	0.955829	0.253544	0.888889	0.222222	0.111111	0 	0 	0.111111	
61	0.987456	0.281086	0.888889	0.222222	0.111111	0 	0 	0.111111	
163	0.913925	0.333142	0.888889	0.222222	0.111111	0 	0 	0.111111	
104	0.985652	0.444225	1	0.333333	-0.111111	0 	0 	0.111111	
53	0.897873	0.348828	1	0.333333	-0.111111	0 	0 	0.111111	
159	0.929699	0.459939	0.888889	0.444444	0.111111	0 	0 	0.111111	
18	0.960404	0.481945	0.888889	0.444444	0.111111	0 	0 	0.111111	
210	0.919335	0.485888	0.888889	0.444444	0.111111	0 	0 	0.111111	
187	0.999551	0.593902	1	0.555556	-0.111111	0 	0 	0.111111	
76	0.947902	0.654947	1	0.555556	-0.111111	0 	0 	0.111111	
127	0.912581	0.623085	1	0.555556	-0.111111	0 	0 	0.111111	
140	0.861072	0.640237	0.888889	0.666667	-0.111111	0 	0 	-0.111111	
191	0.87634	0.664005	0.888889	0.666667	-0.111111	0 	0 	-0.111111	
8	0.781388	0.558603	0.888889	0.666667	-0.111111	0 	0 	-0.111111	
82	0.821375	0.555547	0.777778	0.555556	0.111111	0 	0 	-0.111111	
31	0.825966	0.512974	0.777778	0.555556	0.111111	0 	0 	-0.111111	
165	0.80487	0.43217	0.888889	0.444444	-0.111111	0 	0 	-0.111111	
54	0.875167	0.398267	0.888889	0.444444	-0.111111	0 	0 	-0.111111	
114	0.848084	0.373407	0.888889	0.444444	-0.111111	0 	0 	-0.111111	
205	0.766303	0.357949	0.777778	0.333333	-0.111111	0 	0 	0.111111	
13	0.708384	0.409196	0.777778	0.333333	-0.111111	0 	0 	0.111111	
145	0.671283	0.379958	0.777778	0.333333	-0.111111	0 	0 	0.111111	
71	0.695603	0.475928	0.666667	0.444444	0.111111	0 	0 	0.111111	
173	0.735721	0.510043	0.666667	0.444444	0.111111	0 	0 	0.111111	
122	0.768642	0.549503	0.666667	0.444444	0.111111	0 	0 	0.111111	
36	0.746251	0.599266	0.777778	0.555556	-0.111111	0 	0 	0.111111	
96	0.715886	0.579249	0.777778	0.555556	-0.111111	0 	0 	0.111111	
125	0.652704	0.659771	0.666667	0.666667	-0.111111	0 	0 	-0.111111	
176	0.62623	0.620037	0.666667	0.666667	-0.111111	0 	0 	-0.111111	
65	0.577353	0.581486	0.666667	0.666667	-0.111111	0 	0 	-0.111111	
21	0.528551	0.598919	0.555556	0.555556	-0.111111	0 	0 	0.111111	
153	0.485597	0.563786	0.555556	0.555556	-0.111111	0 	0 	0.111111	
213	0.454609	0.634678	0.555556	0.555556	-0.111111	0 	0 	0.111111	
34	0.388962	0.640753	0.444444	0.666667	-0.111111	0 	0 	-0.111111	
85	0.34624	0.610315	0.444444	0.666667	-0.111111	0 	0 	-0.111111	
168	0.354388	0.540889	0.333333	0.555556	0.111111	0 	0 	-0.111111	
108	0.402876	0.471508	0.333333	0.555556	0.111111	0 	0 	-0.111111	
57	0.432099	0.506173	0.333333	0.555556	0.111111	0 	0 	-0.111111	
47	0.458419	0.471486	0.444444	0.444444	0.111111	0 	0 	0.111111	
107	0.535804	0.542212	0.444444	0.444444	0.111111	0 	0 	0.111111	
148	0.583361	0.496024	0.555556	0.555556	0.111111	0 	0 	-0.111111	
16	0.597725	0.529664	0.555556	0.555556	0.111111	0 	0 	-0.111111	
199	0.638467	0.448887	0.555556	0.555556	0.111111	0 	0 	-0.111111	
39	0.651478	0.38932	0.666667	0.444444	-0.111111	0 	0 	-0.111111	
90	0.604347	0.354153	0.666667	0.444444	-0.111111	0 	0 	-0.111111	
181	0.524392	0.360526	0.555556	0.333333	-0.111111	0 	0 	0.111111	
79	0.505752	0.430154	0.555556	0.333333	-0.111111	0 	0 	0.111111	
130	0.473643	0.404802	0.555556	0.333333	-0.111111	0 	0 	0.111111	
143	0.418814	0.420258	0.444444	0.444444	-0.111111	0 	0 	-0.111111	
194	0.374753	0.369478	0.444444	0.444444	-0.111111	0 	0 	-0.111111	
2	0.333333	0.333333	0.444444	0.444444	-0.111111	0 	0 	-0.111111	
28	0.271312	0.420631	0.333333	0.333333	-0.111111	0 	0 	0.111111	
88	0.239787	0.391876	0.333333	0.333333	-0.111111	0 	0 	0.111111	
5	0.222507	0.447284	0.222222	0.444444	0.111111	0 	0 	0.111111	
197	0.263927	0.492729	0.222222	0.444444	0.111111	0 	0 	0.111111	
137	0.300126	0.531637	0.222222	0.444444	0.111111	0 	0 	0.111111	
60	0.3216	0.618002	0.333333	0.555556	-0.111111	0 	0 	0.111111	
111	0.287907	0.593379	0.333333	0.555556	-0.111111	0 	0 	0.111111	
162	0.245569	0.655828	0.333333	0.555556	-0.111111	0 	0 	0.111111	
10	0.148269	0.623507	0.222222	0.666667	-0.111111	0 	0 	-0.111111	
151	0.113104	0.603783	0.222222	0.666667	-0.111111	0 	0 	-0.111111	
202	0.196465	0.56594	0.222222	0.666667	-0.111111	0 	0 	-0.111111	
93	0.163327	0.463827	0.111111	0.555556	0.111111	0 	0 	-0.111111	
42	0.197772	0.493567	0.111111	0.555556	0.111111	0 	0 	-0.111111	
119	0.201222	0.440887	0.222222	0.444444	-0.111111	0 	0 	-0.111111	
179	0.173042	0.389685	0.222222	0.444444	-0.111111	0 	0 	-0.111111	
68	0.137109	0.35527	0.222222	0.444444	-0.111111	0 	0 	-0.111111	
24	0.093674	0.347255	0.111111	0.333333	-0.111111	0 	0 	0.111111	
156	0.0967049	0.345018	0.111111	0.333333	-0.111111	0 	0 	0.111111	
207	0.0127487	0.414198	0.111111	0.333333	-0.111111	0 	0 	0.111111	
184	0.0970356	0.474158	0	0.444444	0.111111	0 	0 	0.111111	
133	0.0397721	0.515019	0	0.444444	0.111111	0 	0 	0.111111	
73	0.0584391	0.546887	0	0.444444	0.111111	0 	0 	0.111111	
101	0.0889955	0.653575	0.111111	0.555556	-0.111111	0 	0 	0.111111	
50	0.0138203	0.563184	0.111111	0.555556	-0.111111	0 	0 	0.111111	
204	0.0809537	0.67209	0	0.666667	0.111111	0 	0 	0.111111	
144	0.0280101	0.73256	0	0.666667	0.111111	0 	0 	0.111111	
12	0.0410393	0.739709	0	0.666667	0.111111	0 	0 	0.111111	
167	0.142119	0.761131	0.111111	0.777778	0.111111	0 	0 	-0.111111	
116	0.183705	0.699601	0.111111	0.777778	0.111111	0 	0 	-0.111111	
56	0.21339	0.731937	0.111111	0.777778	0.111111	0 	0 	-0.111111	
52	0.236271	0.690387	0.222222	0.666667	0.111111	0 	0 	0.111111	
103	0.3143	0.760345	0.222222	0.666667	0.111111	0 	0 	0.111111	
20	0.320653	0.819006	0.333333	0.777778	-0.111111	0 	0 	0.111111	
161	0.259082	0.790466	0.333333	0.777778	-0.111111	0 	0 	0.111111	
212	0.233779	0.859774	0.333333	0.777778	-0.111111	0 	0 	0.111111	
30	0.162148	0.862222	0.222222	0.888889	-0.111111	0 	0 	-0.111111	
81	0.128565	0.834493	0.222222	0.888889	-0.111111	0 	0 	-0.111111	
121	0.110935	0.877328	0.111111	0.777778	-0.111111	0 	0 	0.111111	
172	0.0699588	0.843621	0.111111	0.777778	-0.111111	0 	0 	0.111111	
70	0.0150947	0.793841	0.111111	0.777778	-0.111111	0 	0 	0.111111	
98	0.0674066	0.9087	0	0.888889	0.111111	0 	0 	0.111111	
38	0.0278611	0.948161	0	0.888889	0.111111	0 	0 	0.111111	
7	0.123086	0.986505	0.111111	1	0.111111	0 	0 	-0.111111	
190	0.156414	0.925222	0.111111	1	0.111111	0 	0 	-0.111111	
139	0.197593	0.962978	0.111111	1	0.111111	0 	0 	-0.111111	
186	0.331439	0.916815	0.222222	0.888889	0.111111	0 	0 	0.111111	
126	0.250936	0.943487	0.222222	0.888889	0.111111	0 	0 	0.111111	
75	0.292211	0.998769	0.222222	0.888889	0.111111	0 	0 	0.111111	
49	0.361777	0.901937	0.333333	1	0.111111	0 	0 	-0.111111	
100	0.427907	0.976247	0.333333	1	0.111111	0 	0 	-0.111111	
72	0.402261	0.888226	0.444444	0.888889	-0.111111	0 	0 	-0.111111	
132	0.349902	0.846166	0.444444	0.888889	-0.111111	0 	0 	-0.111111	
183	0.440394	0.807768	0.444444	0.888889	-0.111111	0 	0 	-0.111111	
209	0.347255	0.772435	0.333333	0.777778	0.111111	0 	0 	-0.111111	
158	0.382973	0.677414	0.333333	0.777778	0.111111	0 	0 	-0.111111	
26	0.408867	0.70451	0.333333	0.777778	0.111111	0 	0 	-0.111111	
67	0.477394	0.695833	0.444444	0.666667	0.111111	0 	0 	0.111111	
178	0.514097	0.732426	0.444444	0.666667	0.111111	0 	0 	0.111111	
118	0.547187	0.776805	0.444444	0.666667	0.111111	0 	0 	0.111111	
44	0.543212	0.833054	0.555556	0.777778	-0.111111	0 	0 	0.111111	
95	0.495927	0.804079	0.555556	0.777778	-0.111111	0 	0 	0.111111	
201	0.52564	0.893611	0.444444	0.888889	0.111111	0 	0 	0.111111	
150	0.455591	0.930959	0.444444	0.888889	0.111111	0 	0 	0.111111	
9	0.480792	0.965	0.444444	0.888889	0.111111	0 	0 	0.111111	
164	0.585038	0.982086	0.555556	1	0.111111	0 	0 	-0.111111	
113	0.620075	0.917941	0.555556	1	0.111111	0 	0 	-0.111111	
62	0.655076	0.953647	0.555556	1	0.111111	0 	0 	-0.111111	
136	0.624672	0.845723	0.666667	0.888889	-0.111111	0 	0 	-0.111111	
196	0.666484	0.876877	0.666667	0.888889	-0.111111	0 	0 	-0.111111	
4	0.555556	0.777778	0.666667	0.888889	-0.111111	0 	0 	-0.111111	
87	0.57527	0.69788	0.555556	0.777778	0.111111	0 	0 	-0.111111	
27	0.61367	0.746551	0.555556	0.777778	0.111111	0 	0 	-0.111111	
1	0.66735	0.680636	0.666667	0.666667	0.111111	0 	0 	0.111111	
193	0.710581	0.705471	0.666667	0.666667	0.111111	0 	0 	0.111111	
142	0.742882	0.749567	0.666667	0.666667	0.111111	0 	0 	0.111111	
129	0.805957	0.723696	0.777778	0.777778	0.111111	0 	0 	-0.111111	
78	0.843461	0.767895	0.777778	0.777778	0.111111	0 	0 	-0.111111	
180	0.805301	0.772547	0.777778	0.777778	0.111111	0 	0 	-0.111111	
92	0.926575	0.684908	0.888889	0.666667	0.111111	0 	0 	0.111111	
41	0.975275	0.712218	0.888889	0.666667	0.111111	0 	0 	0.111111	
198	0.961925	0.795375	1	0.777778	-0.111111	0 	0 	0.111111	
15	0.930476	0.858824	1	0.777778	-0.111111	0 	0 	0.111111	
147	0.889276	0.823673	1	0.777778	-0.111111	0 	0 	0.111111	
106	0.876767	0.887753	0.888889	0.888889	-0.111111	0 	0 	-0.111111	
46	0.790123	0.790123	0.888889	0.888889	-0.111111	0 	0 	-0.111111	
59	0.77771	0.833637	0.777778	0.777778	-0.111111	0 	0 	0.111111	
110	0.762616	0.833472	0.777778	0.777778	-0.111111	0 	0 	0.111111	
170	0.697774	0.8786	0.777778	0.777778	-0.111111	0 	0 	0.111111	
84	0.691796	0.958757	0.666667	0.888889	0.111111	0 	0 	0.111111	
33	0.727783	0.977428	0.666667	0.888889	0.111111	0 	0 	0.111111	
155	0.822147	0.905213	0.777778	1	0.111111	0 	0 	-0.111111	
23	0.849751	0.928693	0.777778	1	0.111111	0 	0 	-0.111111	
64	0.910837	0.94427	0.888889	0.888889	0.111111	0 	0 	0.111111	
175	0.958947	0.959315	0.888889	0.888889	0.111111	0 	0 	0.111111	
124	0.990831	0.998622	0.888889	0.888889	0.111111	0 	0 	0.111111	
