0	0.0074037	0.000106104	0	0	0.111111	0 	0 	0.111111	
192	0.0477063	0.0438247	0	0	0.111111	0 	0 	0.111111	
141	0.106276	0.0859014	0	0	0.111111	0 	0 	0.111111	
131	0.139917	0.0847162	0.111111	0.111111	0.111111	0 	0 	-0.111111	
80	0.180567	0.103334	0.111111	0.111111	0.111111	0 	0 	-0.111111	
182	0.223298	0.0293445	0.111111	0.111111	0.111111	0 	0 	-0.111111	
91	0.292345	0.0142942	0.222222	0	0.111111	0 	0 	0.111111	
40	0.311111	0.0491694	0.222222	0	0.111111	0 	0 	0.111111	
17	0.256008	0.184741	0.333333	0.111111	-0.111111	0 	0 	0.111111	
149	0.231718	0.160329	0.333333	0.111111	-0.111111	0 	0 	0.111111	
105	0.195393	0.214902	0.222222	0.222222	-0.111111	0 	0 	-0.111111	
45	0.126109	0.12628	0.222222	0.222222	-0.111111	0 	0 	-0.111111	
58	0.0969444	0.206539	0.111111	0.111111	-0.111111	0 	0 	0.111111	
109	0.070143	0.141046	0.111111	0.111111	-0.111111	0 	0 	0.111111	
169	0.0149154	0.221917	0.111111	0.111111	-0.111111	0 	0 	0.111111	
86	0.0139559	0.322797	0	0.222222	0.111111	0 	0 	0.111111	
35	0.0491471	0.311114	0	0.222222	0.111111	0 	0 	0.111111	
154	0.152096	0.243844	0.111111	0.333333	0.111111	0 	0 	-0.111111	
22	0.180219	0.264744	0.111111	0.333333	0.111111	0 	0 	-0.111111	
63	0.272574	0.226987	0.222222	0.222222	0.111111	0 	0 	0.111111	
174	0.28774	0.286469	0.222222	0.222222	0.111111	0 	0 	0.111111	
123	0.319506	0.328221	0.222222	0.222222	0.111111	0 	0 	0.111111	
97	0.347924	0.273659	0.333333	0.333333	0.111111	0 	0 	-0.111111	
37	0.427477	0.272198	0.333333	0.333333	0.111111	0 	0 	-0.111111	
120	0.40128	0.187765	0.444444	0.222222	-0.111111	0 	0 	-0.111111	
171	0.430396	0.173238	0.444444	0.222222	-0.111111	0 	0 	-0.111111	
69	0.350089	0.133087	0.444444	0.222222	-0.111111	0 	0 	-0.111111	
146	0.366284	0.0762715	0.333333	0.111111	0.111111	0 	0 	-0.111111	
14	0.375068	0.0668892	0.333333	0.111111	0.111111	0 	0 	-0.111111	
115	0.517297	0.0312888	0.444444	0	0.111111	0 	0 	0.111111	
55	0.544302	0.0710853	0.444444	0	0.111111	0 	0 	0.111111	
166	0.486254	0.107941	0.444444	0	0.111111	0 	0 	0.111111	
32	0.554658	0.151012	0.555556	0.111111	-0.111111	0 	0 	0.111111	
83	0.455174	0.164342	0.555556	0.111111	-0.111111	0 	0 	0.111111	
6	0.450042	0.227403	0.444444	0.222222	0.111111	0 	0 	0.111111	
189	0.48855	0.260655	0.444444	0.222222	0.111111	0 	0 	0.111111	
138	0.523027	0.304704	0.444444	0.222222	0.111111	0 	0 	0.111111	
128	0.581688	0.28145	0.555556	0.333333	0.111111	0 	0 	-0.111111	
77	0.617983	0.317093	0.555556	0.333333	0.111111	0 	0 	-0.111111	
188	0.662846	0.250849	0.555556	0.333333	0.111111	0 	0 	-0.111111	
19	0.629935	0.148353	0.666667	0.222222	-0.111111	0 	0 	-0.111111	
160	0.59331	0.118471	0.666667	0.222222	-0.111111	0 	0 	-0.111111	
51	0.558773	0.0229408	0.555556	0.111111	0.111111	0 	0 	-0.111111	
102	0.644754	0.0877114	0.555556	0.111111	0.111111	0 	0 	-0.111111	
157	0.704959	0.0124731	0.666667	0	0.111111	0 	0 	0.111111	
25	0.740414	0.0408576	0.666667	0	0.111111	0 	0 	0.111111	
66	0.794726	0.0196173	0.777778	0.111111	0.111111	0 	0 	-0.111111	
177	0.833054	0.0601407	0.777778	0.111111	0.111111	0 	0 	-0.111111	
117	0.878677	0.106744	0.777778	0.111111	0.111111	0 	0 	-0.111111	
89	0.889394	0.0411698	0.888889	0	0.111111	0 	0 	0.111111	
29	0.936299	0.0841032	0.888889	0	0.111111	0 	0 	0.111111	
135	0.984204	0.205568	1	0.111111	-0.111111	0 	0 	0.111111	
195	0.943132	0.169457	1	0.111111	-0.111111	0 	0 	0.111111	
3	0.888889	0.111111	1	0.111111	-0.111111	0 	0 	0.111111	
43	0.864503	0.221313	0.888889	0.222222	-0.111111	0 	0 	-0.111111	
94	0.831276	0.131687	0.888889	0.222222	-0.111111	0 	0 	-0.111111	
185	0.763175	0.150073	0.777778	0.111111	-0.111111	0 	0 	0.111111	
74	0.72	0.207202	0.777778	0.111111	-0.111111	0 	0 	0.111111	
134	0.708699	0.175946	0.777778	0.111111	-0.111111	0 	0 	0.111111	
48	0.684734	0.229269	0.666667	0.222222	0.111111	0 	0 	0.111111	
99	0.758844	0.317898	0.666667	0.222222	0.111111	0 	0 	0.111111	
152	0.777899	0.24762	0.777778	0.333333	0.111111	0 	0 	-0.111111	
11	0.818456	0.301559	0.777778	0.333333	0.111111	0 	0 	-0.111111	
112	0.952565	0.260256	0.888889	0.222222	0.111111	0 	0 	0.111111	
61	0.986817	0.282546	0.888889	0.222222	0.111111	0 	0 	0.111111	
163	0.91871	0.327023	0.888889	0.222222	0.111111	0 	0 	0.111111	
104	0.977196	0.426912	1	0.333333	-0.111111	0 	0 	0.111111	
53	0.902361	0.350178	1	0.333333	-0.111111	0 	0 	0.111111	
159	0.930041	0.452675	0.888889	0.444444	0.111111	0 	0 	0.111111	
18	0.96061	0.48046	0.888889	0.444444	0.111111	0 	0 	0.111111	
187	0.998999	0.599445	1	0.555556	-0.111111	0 	0 	0.111111	
76	0.956366	0.649472	1	0.555556	-0.111111	0 	0 	0.111111	
127	0.906251	0.626386	1	0.555556	-0.111111	0 	0 	0.111111	
140	0.874965	0.656859	0.888889	0.666667	-0.111111	0 	0 	-0.111111	
191	0.829259	0.592825	0.888889	0.666667	-0.111111	0 	0 	-0.111111	
8	0.780322	0.556088	0.888889	0.666667	-0.111111	0 	0 	-0.111111	
82	0.793818	0.480558	0.777778	0.555556	0.111111	0 	0 	-0.111111	
31	0.832102	0.515614	0.777778	0.555556	0.111111	0 	0 	-0.111111	
165	0.810109	0.43874	0.888889	0.444444	-0.111111	0 	0 	-0.111111	
54	0.873749	0.384346	0.888889	0.444444	-0.111111	0 	0 	-0.111111	
114	0.850968	0.365931	0.888889	0.444444	-0.111111	0 	0 	-0.111111	
13	0.708114	0.410816	0.777778	0.333333	-0.111111	0 	0 	0.111111	
145	0.670782	0.378601	0.777778	0.333333	-0.111111	0 	0 	0.111111	
71	0.688457	0.454991	0.666667	0.444444	0.111111	0 	0 	0.111111	
173	0.735191	0.514793	0.666667	0.444444	0.111111	0 	0 	0.111111	
122	0.77076	0.549934	0.666667	0.444444	0.111111	0 	0 	0.111111	
36	0.747245	0.584618	0.777778	0.555556	-0.111111	0 	0 	0.111111	
96	0.707848	0.582125	0.777778	0.555556	-0.111111	0 	0 	0.111111	
125	0.638815	0.649938	0.666667	0.666667	-0.111111	0 	0 	-0.111111	
176	0.624899	0.630723	0.666667	0.666667	-0.111111	0 	0 	-0.111111	
65	0.585382	0.580867	0.666667	0.666667	-0.111111	0 	0 	-0.111111	
21	0.506333	0.587395	0.555556	0.555556	-0.111111	0 	0 	0.111111	
153	0.483314	0.563623	0.555556	0.555556	-0.111111	0 	0 	0.111111	
34	0.394609	0.638635	0.444444	0.666667	-0.111111	0 	0 	-0.111111	
85	0.343327	0.613706	0.444444	0.666667	-0.111111	0 	0 	-0.111111	
168	0.348558	0.55542	0.333333	0.555556	0.111111	0 	0 	-0.111111	
108	0.402779	0.470403	0.333333	0.555556	0.111111	0 	0 	-0.111111	
57	0.445206	0.509266	0.333333	0.555556	0.111111	0 	0 	-0.111111	
47	0.472493	0.479822	0.444444	0.444444	0.111111	0 	0 	0.111111	
107	0.537129	0.5413	0.444444	0.444444	0.111111	0 	0 	0.111111	
148	0.574449	0.48028	0.555556	0.555556	0.111111	0 	0 	-0.111111	
16	0.599173	0.517535	0.555556	0.555556	0.111111	0 	0 	-0.111111	
39	0.65211	0.382542	0.666667	0.444444	-0.111111	0 	0 	-0.111111	
90	0.605152	0.361442	0.666667	0.444444	-0.111111	0 	0 	-0.111111	
181	0.550701	0.346976	0.555556	0.333333	-0.111111	0 	0 	0.111111	
79	0.50881	0.431337	0.555556	0.333333	-0.111111	0 	0 	0.111111	
130	0.470541	0.407057	0.555556	0.333333	-0.111111	0 	0 	0.111111	
143	0.405989	0.413628	0.444444	0.444444	-0.111111	0 	0 	-0.111111	
194	0.374943	0.357426	0.444444	0.444444	-0.111111	0 	0 	-0.111111	
2	0.333439	0.33569	0.444444	0.444444	-0.111111	0 	0 	-0.111111	
28	0.271605	0.419753	0.333333	0.333333	-0.111111	0 	0 	0.111111	
88	0.237527	0.390738	0.333333	0.333333	-0.111111	0 	0 	0.111111	
5	0.236217	0.481491	0.222222	0.444444	0.111111	0 	0 	0.111111	
137	0.301171	0.53013	0.222222	0.444444	0.111111	0 	0 	0.111111	
60	0.313421	0.622561	0.333333	0.555556	-0.111111	0 	0 	0.111111	
111	0.285192	0.590408	0.333333	0.555556	-0.111111	0 	0 	0.111111	
162	0.24915	0.658659	0.333333	0.555556	-0.111111	0 	0 	0.111111	
10	0.149849	0.622181	0.222222	0.666667	-0.111111	0 	0 	-0.111111	
151	0.117485	0.599865	0.222222	0.666667	-0.111111	0 	0 	-0.111111	
93	0.161212	0.468101	0.111111	0.555556	0.111111	0 	0 	-0.111111	
42	0.198683	0.497897	0.111111	0.555556	0.111111	0 	0 	-0.111111	
119	0.205051	0.429766	0.222222	0.444444	-0.111111	0 	0 	-0.111111	
179	0.194313	0.443354	0.222222	0.444444	-0.111111	0 	0 	-0.111111	
68	0.132457	0.356408	0.222222	0.444444	-0.111111	0 	0 	-0.111111	
24	0.0826681	0.370008	0.111111	0.333333	-0.111111	0 	0 	0.111111	
156	0.0822805	0.390225	0.111111	0.333333	-0.111111	0 	0 	0.111111	
184	0.0998568	0.472139	0	0.444444	0.111111	0 	0 	0.111111	
133	0.0277966	0.512675	0	0.444444	0.111111	0 	0 	0.111111	
73	0.0633502	0.549638	0	0.444444	0.111111	0 	0 	0.111111	
101	0.0937038	0.640233	0.111111	0.555556	-0.111111	0 	0 	0.111111	
50	0.0136532	0.56078	0.111111	0.555556	-0.111111	0 	0 	0.111111	
144	0.0417234	0.670295	0	0.666667	0.111111	0 	0 	0.111111	
12	0.0391549	0.73638	0	0.666667	0.111111	0 	0 	0.111111	
167	0.142198	0.763064	0.111111	0.777778	0.111111	0 	0 	-0.111111	
116	0.179305	0.700092	0.111111	0.777778	0.111111	0 	0 	-0.111111	
56	0.210368	0.726054	0.111111	0.777778	0.111111	0 	0 	-0.111111	
52	0.250494	0.682499	0.222222	0.666667	0.111111	0 	0 	0.111111	
103	0.308211	0.763968	0.222222	0.666667	0.111111	0 	0 	0.111111	
20	0.320422	0.825605	0.333333	0.777778	-0.111111	0 	0 	0.111111	
161	0.260863	0.785532	0.333333	0.777778	-0.111111	0 	0 	0.111111	
30	0.19463	0.872149	0.222222	0.888889	-0.111111	0 	0 	-0.111111	
81	0.125812	0.836016	0.222222	0.888889	-0.111111	0 	0 	-0.111111	
121	0.0971329	0.781879	0.111111	0.777778	-0.111111	0 	0 	0.111111	
172	0.073503	0.851937	0.111111	0.777778	-0.111111	0 	0 	0.111111	
70	0.0170755	0.798855	0.111111	0.777778	-0.111111	0 	0 	0.111111	
98	0.0572491	0.911081	0	0.888889	0.111111	0 	0 	0.111111	
38	0.0145556	0.986129	0	0.888889	0.111111	0 	0 	0.111111	
7	0.128897	0.889032	0.111111	1	0.111111	0 	0 	-0.111111	
190	0.156236	0.929224	0.111111	1	0.111111	0 	0 	-0.111111	
139	0.194768	0.970981	0.111111	1	0.111111	0 	0 	-0.111111	
186	0.23767	0.917056	0.222222	0.888889	0.111111	0 	0 	0.111111	
126	0.249091	0.941893	0.222222	0.888889	0.111111	0 	0 	0.111111	
75	0.305876	0.995929	0.222222	0.888889	0.111111	0 	0 	0.111111	
49	0.346753	0.892502	0.333333	1	0.111111	0 	0 	-0.111111	
100	0.41667	0.980987	0.333333	1	0.111111	0 	0 	-0.111111	
72	0.396824	0.875372	0.444444	0.888889	-0.111111	0 	0 	-0.111111	
132	0.360706	0.848236	0.444444	0.888889	-0.111111	0 	0 	-0.111111	
183	0.429128	0.792122	0.444444	0.888889	-0.111111	0 	0 	-0.111111	
158	0.379162	0.68101	0.333333	0.777778	0.111111	0 	0 	-0.111111	
26	0.410531	0.706829	0.333333	0.777778	0.111111	0 	0 	-0.111111	
67	0.44471	0.691334	0.444444	0.666667	0.111111	0 	0 	0.111111	
178	0.512506	0.734997	0.444444	0.666667	0.111111	0 	0 	0.111111	
118	0.541564	0.776004	0.444444	0.666667	0.111111	0 	0 	0.111111	
44	0.513402	0.83092	0.555556	0.777778	-0.111111	0 	0 	0.111111	
95	0.495479	0.803107	0.555556	0.777778	-0.111111	0 	0 	0.111111	
150	0.444959	0.946629	0.444444	0.888889	0.111111	0 	0 	0.111111	
9	0.465884	0.91877	0.444444	0.888889	0.111111	0 	0 	0.111111	
164	0.555982	0.964542	0.555556	1	0.111111	0 	0 	-0.111111	
113	0.622039	0.923405	0.555556	1	0.111111	0 	0 	-0.111111	
62	0.583782	0.986047	0.555556	1	0.111111	0 	0 	-0.111111	
136	0.649294	0.860566	0.666667	0.888889	-0.111111	0 	0 	-0.111111	
196	0.644984	0.888802	0.666667	0.888889	-0.111111	0 	0 	-0.111111	
4	0.553596	0.7781	0.666667	0.888889	-0.111111	0 	0 	-0.111111	
87	0.569677	0.708346	0.555556	0.777778	0.111111	0 	0 	-0.111111	
27	0.608931	0.7541	0.555556	0.777778	0.111111	0 	0 	-0.111111	
1	0.670877	0.680903	0.666667	0.666667	0.111111	0 	0 	0.111111	
193	0.709851	0.704043	0.666667	0.666667	0.111111	0 	0 	0.111111	
142	0.743742	0.748357	0.666667	0.666667	0.111111	0 	0 	0.111111	
129	0.814241	0.770311	0.777778	0.777778	0.111111	0 	0 	-0.111111	
78	0.847602	0.761257	0.777778	0.777778	0.111111	0 	0 	-0.111111	
180	0.887626	0.691217	0.777778	0.777778	0.111111	0 	0 	-0.111111	
92	0.93749	0.694978	0.888889	0.666667	0.111111	0 	0 	0.111111	
41	0.973364	0.722825	0.888889	0.666667	0.111111	0 	0 	0.111111	
15	0.933083	0.850207	1	0.777778	-0.111111	0 	0 	0.111111	
147	0.901823	0.817365	1	0.777778	-0.111111	0 	0 	0.111111	
106	0.872526	0.860256	0.888889	0.888889	-0.111111	0 	0 	-0.111111	
46	0.788769	0.7928	0.888889	0.888889	-0.111111	0 	0 	-0.111111	
59	0.764514	0.844652	0.777778	0.777778	-0.111111	0 	0 	0.111111	
110	0.764093	0.833182	0.777778	0.777778	-0.111111	0 	0 	0.111111	
170	0.698716	0.880696	0.777778	0.777778	-0.111111	0 	0 	0.111111	
84	0.680701	0.954687	0.666667	0.888889	0.111111	0 	0 	0.111111	
33	0.722401	0.972216	0.666667	0.888889	0.111111	0 	0 	0.111111	
155	0.817558	0.896645	0.777778	1	0.111111	0 	0 	-0.111111	
23	0.848262	0.925365	0.777778	1	0.111111	0 	0 	-0.111111	
64	0.922136	0.933728	0.888889	0.888889	0.111111	0 	0 	0.111111	
175	0.964464	0.956577	0.888889	0.888889	0.111111	0 	0 	0.111111	
124	0.991242	0.992944	0.888889	0.888889	0.111111	0 	0 	0.111111	
