0	0.5009461334916647	0.5902787363077916	0.4444444444444444	0.5555555555555556	0.1111111111111111	0.	0.	0.1111111111111111
1	0.30647138024752224	0.9588609634255388	0.2222222222222222	0.8888888888888888	0.1111111111111111	0.	0.	0.1111111111111111
2	0.8739910027491259	0.05349079081187504	0.7777777777777778	0.	0.1111111111111111	0.	0.	0.1111111111111111
3	0.6647559597706254	0.17301381806887353	0.5555555555555556	0.1111111111111111	0.1111111111111111	0.	0.	0.1111111111111111
4	0.08132921178569882	0.3343964004959996	0.	0.3333333333333333	0.1111111111111111	0.	0.	0.1111111111111111
5	0.9586426098044254	0.7435650948927142	0.8888888888888888	0.6666666666666666	0.1111111111111111	0.	0.	0.1111111111111111
6	0.38697946440652337	0.7932996646442207	0.3333333333333333	0.7777777777777778	0.1111111111111111	0.	0.	0.1111111111111111
7	0.14964890942220324	0.2619986695300121	0.1111111111111111	0.2222222222222222	0.1111111111111111	0.	0.	0.1111111111111111
8	0.7465315995028167	0.46605794511812726	0.6666666666666666	0.4444444444444444	0.1111111111111111	0.	0.	0.1111111111111111
9	0.4143520091421908	0.22299373794864014	0.3333333333333333	0.2222222222222222	0.1111111111111111	0.	0.	0.1111111111111111
10	0.21935481923707284	0.5380118250104561	0.1111111111111111	0.4444444444444444	0.1111111111111111	0.	0.	0.1111111111111111
11	0.7009624521949329	0.8643166933796319	0.6666666666666666	0.7777777777777778	0.1111111111111111	0.	0.	0.1111111111111111
12	0.5238625045116462	0.9042582128380929	0.4444444444444444	0.8888888888888888	0.1111111111111111	0.	0.	0.1111111111111111
13	0.24355745762670114	0.0245317123638239	0.2222222222222222	0.	0.1111111111111111	0.	0.	0.1111111111111111
14	0.7961400427293011	0.6459283649296103	0.7777777777777778	0.5555555555555556	0.1111111111111111	0.	0.	0.1111111111111111
15	0.5793413109857493	0.42113866362911956	0.5555555555555556	0.3333333333333333	0.1111111111111111	0.	0.	0.1111111111111111
16	0.007055698078993442	0.7125745750977391	0.	0.6666666666666666	0.1111111111111111	0.	0.	0.1111111111111111
17	0.995317303244985	0.11513580704469831	0.8888888888888888	0.1111111111111111	0.1111111111111111	0.	0.	0.1111111111111111
18	0.6056418482296636	0.6690691854451716	0.5555555555555556	0.6666666666666666	0.1111111111111111	0.	0.	0.1111111111111111
19	0.06247360001310274	0.2127514548324951	0.	0.1111111111111111	0.1111111111111111	0.	0.	0.1111111111111111
20	0.9186236439171221	0.400600718702137	0.8888888888888888	0.3333333333333333	0.1111111111111111	0.	0.	0.1111111111111111
21	0.33483672654528435	0.48352984242916497	0.3333333333333333	0.4444444444444444	0.1111111111111111	0.	0.	0.1111111111111111
22	0.1316801970515641	0.8424410847305497	0.1111111111111111	0.7777777777777778	0.1111111111111111	0.	0.	0.1111111111111111
23	0.7120571786107404	0.30723659876783993	0.6666666666666666	0.2222222222222222	0.1111111111111111	0.	0.	0.1111111111111111
24	0.44800759965313386	0.0888562994922037	0.4444444444444444	0.	0.1111111111111111	0.	0.	0.1111111111111111
25	0.2760269079797343	0.6132094603803983	0.2222222222222222	0.5555555555555556	0.1111111111111111	0.	0.	0.1111111111111111
26	0.821323996453201	0.9634136076886735	0.7777777777777778	0.8888888888888888	0.1111111111111111	0.	0.	0.1111111111111111
27	0.8867943722339718	0.5529413124731941	0.7777777777777778	0.4444444444444444	0.1111111111111111	0.	0.	0.1111111111111111
28	0.5120732175146611	0.8817576346613925	0.4444444444444444	0.7777777777777778	0.1111111111111111	0.	0.	0.1111111111111111
29	0.3118944818291908	0.23841449438674372	0.2222222222222222	0.2222222222222222	0.1111111111111111	0.	0.	0.1111111111111111
30	0.9273761546806921	0.03647891133260809	0.8888888888888888	0.	0.1111111111111111	0.	0.	0.1111111111111111
31	0.6372128002416173	0.6627597196251196	0.5555555555555556	0.5555555555555556	0.1111111111111111	0.	0.	0.1111111111111111
32	0.09776005763426036	0.9225241018852431	0.	0.8888888888888888	0.1111111111111111	0.	0.	0.1111111111111111
33	0.7603628882931899	0.7233807476816231	0.6666666666666666	0.6666666666666666	0.1111111111111111	0.	0.	0.1111111111111111
34	0.40471977894454286	0.12372794339571791	0.3333333333333333	0.1111111111111111	0.1111111111111111	0.	0.	0.1111111111111111
35	0.1703242993256697	0.4436462281855896	0.1111111111111111	0.3333333333333333	0.1111111111111111	0.	0.	0.1111111111111111
36	0.671701161198352	0.18719206321239934	0.6666666666666666	0.1111111111111111	0.1111111111111111	0.	0.	0.1111111111111111
37	0.4275528365253807	0.3767612128880807	0.3333333333333333	0.3333333333333333	0.1111111111111111	0.	0.	0.1111111111111111
38	0.19644337481937701	0.6884689398379583	0.1111111111111111	0.6666666666666666	0.1111111111111111	0.	0.	0.1111111111111111
39	0.8072649138251093	0.8149868122574523	0.7777777777777778	0.7777777777777778	0.1111111111111111	0.	0.	0.1111111111111111
40	0.541132695058194	0.31370919913668627	0.4444444444444444	0.2222222222222222	0.1111111111111111	0.	0.	0.1111111111111111
41	0.2541156619106947	0.49615104464269405	0.2222222222222222	0.4444444444444444	0.1111111111111111	0.	0.	0.1111111111111111
42	0.9743871359025277	0.626096760205163	0.8888888888888888	0.5555555555555556	0.1111111111111111	0.	0.	0.1111111111111111
43	0.5920630361911501	0.9769252136791352	0.5555555555555556	0.8888888888888888	0.1111111111111111	0.	0.	0.1111111111111111
44	0.014393294860905851	0.10068754778738612	0.	0.	0.1111111111111111	0.	0.	0.1111111111111111
45	0.9001483450195119	0.9351273141708656	0.8888888888888888	0.8888888888888888	0.1111111111111111	0.	0.	0.1111111111111111
46	0.6223698432222051	0.06707026449152685	0.5555555555555556	0.	0.1111111111111111	0.	0.	0.1111111111111111
47	0.044240355083543355	0.5592138236137532	0.	0.5555555555555556	0.1111111111111111	0.	0.	0.1111111111111111
48	0.7164851065306805	0.3477038209337796	0.6666666666666666	0.3333333333333333	0.1111111111111111	0.	0.	0.1111111111111111
49	0.3505674855174391	0.7599606414552157	0.3333333333333333	0.6666666666666666	0.1111111111111111	0.	0.	0.1111111111111111
50	0.14298967548925892	0.1544279080879139	0.1111111111111111	0.1111111111111111	0.1111111111111111	0.	0.	0.1111111111111111
51	0.8346301985764791	0.2806920983469204	0.7777777777777778	0.2222222222222222	0.1111111111111111	0.	0.	0.1111111111111111
52	0.46264066500279155	0.48140300516389745	0.4444444444444444	0.4444444444444444	0.1111111111111111	0.	0.	0.1111111111111111
53	0.2930630462000854	0.8038464945512989	0.2222222222222222	0.7777777777777778	0.1111111111111111	0.	0.	0.1111111111111111
54	0.3287730720233883	0.3880002450429685	0.2222222222222222	0.3333333333333333	0.1111111111111111	0.	0.	0.1111111111111111
55	0.8591397971554708	0.6954698817353118	0.7777777777777778	0.6666666666666666	0.1111111111111111	0.	0.	0.1111111111111111
56	0.48585824965665847	0.20774899095919183	0.4444444444444444	0.1111111111111111	0.1111111111111111	0.	0.	0.1111111111111111
57	0.10136670133623212	0.32734747972161765	0.	0.2222222222222222	0.1111111111111111	0.	0.	0.1111111111111111
58	0.9492455358153933	0.5174188477161311	0.8888888888888888	0.4444444444444444	0.1111111111111111	0.	0.	0.1111111111111111
59	0.6491566600306127	0.8312725969431112	0.5555555555555556	0.7777777777777778	0.1111111111111111	0.	0.	0.1111111111111111
60	0.17930772972963063	0.9965912377614771	0.1111111111111111	0.8888888888888888	0.1111111111111111	0.	0.	0.1111111111111111
61	0.7725207403782922	0.07539336155243972	0.6666666666666666	0.	0.1111111111111111	0.	0.	0.1111111111111111
62	0.3758768025990145	0.6004402880199762	0.3333333333333333	0.5555555555555556	0.1111111111111111	0.	0.	0.1111111111111111
63	0.20676078732979283	0.03838455654488285	0.1111111111111111	0.	0.1111111111111111	0.	0.	0.1111111111111111
64	0.6890118564001229	0.5706174701909824	0.6666666666666666	0.5555555555555556	0.1111111111111111	0.	0.	0.1111111111111111
65	0.44185986508318104	0.9481085911282303	0.3333333333333333	0.8888888888888888	0.1111111111111111	0.	0.	0.1111111111111111
66	0.23370359141399644	0.7661590969702174	0.2222222222222222	0.6666666666666666	0.1111111111111111	0.	0.	0.1111111111111111
67	0.7885181493330882	0.16215202374940302	0.7777777777777778	0.1111111111111111	0.1111111111111111	0.	0.	0.1111111111111111
68	0.5470173752219903	0.3600234756814836	0.4444444444444444	0.3333333333333333	0.1111111111111111	0.	0.	0.1111111111111111
69	0.034669963811163676	0.4551885698882935	0.	0.4444444444444444	0.1111111111111111	0.	0.	0.1111111111111111
70	0.9840169492601789	0.7806912332231695	0.8888888888888888	0.7777777777777778	0.1111111111111111	0.	0.	0.1111111111111111
71	0.5562525828794427	0.29375409982511275	0.5555555555555556	0.2222222222222222	0.1111111111111111	0.	0.	0.1111111111111111
72	0.05277254537080855	0.8530030549485644	0.	0.7777777777777778	0.1111111111111111	0.	0.	0.1111111111111111
73	0.9038530630388697	0.2551829217616142	0.8888888888888888	0.2222222222222222	0.1111111111111111	0.	0.	0.1111111111111111
74	0.5985316503657263	0.5291865939490877	0.5555555555555556	0.4444444444444444	0.1111111111111111	0.	0.	0.1111111111111111
75	0.1218342051427573	0.6317838178833818	0.1111111111111111	0.5555555555555556	0.1111111111111111	0.	0.	0.1111111111111111
76	0.7319111147990937	0.891175721994404	0.6666666666666666	0.8888888888888888	0.1111111111111111	0.	0.	0.1111111111111111
77	0.3682699712181028	0.001020895928919237	0.3333333333333333	0.	0.1111111111111111	0.	0.	0.1111111111111111
78	0.2712911913133226	0.14516619864848362	0.2222222222222222	0.1111111111111111	0.1111111111111111	0.	0.	0.1111111111111111
79	0.8418365495033658	0.41910384696596	0.7777777777777778	0.3333333333333333	0.1111111111111111	0.	0.	0.1111111111111111
80	0.47926414478645024	0.738216030007988	0.4444444444444444	0.6666666666666666	0.1111111111111111	0.	0.	0.1111111111111111
81	0.8015823732027761	0.7112562125403407	0.7777777777777778	0.6666666666666666	0.1111111111111111	0.	0.	0.1111111111111111
82	0.5277790449195026	0.11990249350665261	0.4444444444444444	0.1111111111111111	0.1111111111111111	0.	0.	0.1111111111111111
83	0.23499260773479644	0.4298841467141232	0.2222222222222222	0.3333333333333333	0.1111111111111111	0.	0.	0.1111111111111111
84	0.995892313274118	0.5343940555847406	0.8888888888888888	0.4444444444444444	0.1111111111111111	0.	0.	0.1111111111111111
85	0.570649456969393	0.8747605714093593	0.5555555555555556	0.7777777777777778	0.1111111111111111	0.	0.	0.1111111111111111
86	0.010517148978148132	0.23098292305340623	0.	0.2222222222222222	0.1111111111111111	0.	0.	0.1111111111111111
87	0.6950993523731782	0.01729783664935009	0.6666666666666666	0.	0.1111111111111111	0.	0.	0.1111111111111111
88	0.41805008665920096	0.6538619997112922	0.3333333333333333	0.5555555555555556	0.1111111111111111	0.	0.	0.1111111111111111
89	0.2138346018142577	0.9120879914708556	0.1111111111111111	0.8888888888888888	0.1111111111111111	0.	0.	0.1111111111111111
90	0.7076474083950681	0.6099723918662787	0.6666666666666666	0.5555555555555556	0.1111111111111111	0.	0.	0.1111111111111111
91	0.33994818654690895	0.9751272086180245	0.3333333333333333	0.8888888888888888	0.1111111111111111	0.	0.	0.1111111111111111
92	0.13257195766604551	0.09764023519847106	0.1111111111111111	0.	0.1111111111111111	0.	0.	0.1111111111111111
93	0.8259024567662105	0.21950878287183212	0.7777777777777778	0.1111111111111111	0.1111111111111111	0.	0.	0.1111111111111111
94	0.4511324971939383	0.3964512995422226	0.4444444444444444	0.3333333333333333	0.1111111111111111	0.	0.	0.1111111111111111
95	0.2830969943874084	0.6749414269276467	0.2222222222222222	0.6666666666666666	0.1111111111111111	0.	0.	0.1111111111111111
96	0.9242183024209302	0.8509898771340754	0.8888888888888888	0.7777777777777778	0.1111111111111111	0.	0.	0.1111111111111111
97	0.6117465606385797	0.30160425597246443	0.5555555555555556	0.2222222222222222	0.1111111111111111	0.	0.	0.1111111111111111
98	0.06646403343250473	0.49000637478761055	0.	0.4444444444444444	0.1111111111111111	0.	0.	0.1111111111111111
99	0.9600587360778433	0.27031741386983454	0.8888888888888888	0.2222222222222222	0.1111111111111111	0.	0.	0.1111111111111111
100	0.6552985886780672	0.46463462941252276	0.5555555555555556	0.4444444444444444	0.1111111111111111	0.	0.	0.1111111111111111
101	0.08265582033616539	0.8018839611070063	0.	0.7777777777777778	0.1111111111111111	0.	0.	0.1111111111111111
102	0.749591824848823	0.957912790375593	0.6666666666666666	0.8888888888888888	0.1111111111111111	0.	0.	0.1111111111111111
103	0.39222170737249434	0.06044323157450079	0.3333333333333333	0.	0.1111111111111111	0.	0.	0.1111111111111111
104	0.1555684285625551	0.5868441261849043	0.1111111111111111	0.5555555555555556	0.1111111111111111	0.	0.	0.1111111111111111
105	0.8666404622360246	0.3442722789673281	0.7777777777777778	0.3333333333333333	0.1111111111111111	0.	0.	0.1111111111111111
106	0.505222000102667	0.7526665615595084	0.4444444444444444	0.6666666666666666	0.1111111111111111	0.	0.	0.1111111111111111
107	0.2983713887505143	0.1830349693594376	0.2222222222222222	0.1111111111111111	0.1111111111111111	0.	0.	0.1111111111111111
108	0.2562566104585484	0.9847506223829754	0.2222222222222222	0.8888888888888888	0.1111111111111111	0.	0.	0.1111111111111111
109	0.8112890057637953	0.10829804959885161	0.7777777777777778	0.	0.1111111111111111	0.	0.	0.1111111111111111
110	0.5340927412850383	0.6233837811642775	0.4444444444444444	0.5555555555555556	0.1111111111111111	0.	0.	0.1111111111111111
111	0.01697282114231875	0.3728123381036085	0.	0.3333333333333333	0.1111111111111111	0.	0.	0.1111111111111111
112	0.966799190977567	0.6846540185608683	0.8888888888888888	0.6666666666666666	0.1111111111111111	0.	0.	0.1111111111111111
113	0.5802469359504285	0.1948819266844024	0.5555555555555556	0.1111111111111111	0.1111111111111111	0.	0.	0.1111111111111111
114	0.18717267945010524	0.3121616506279649	0.1111111111111111	0.2222222222222222	0.1111111111111111	0.	0.	0.1111111111111111
115	0.6785618360347828	0.5057114622556785	0.6666666666666666	0.4444444444444444	0.1111111111111111	0.	0.	0.1111111111111111
116	0.42942036466911454	0.8252513098242464	0.3333333333333333	0.7777777777777778	0.1111111111111111	0.	0.	0.1111111111111111
117	0.1466399616946089	0.4738565801562447	0.1111111111111111	0.4444444444444444	0.1111111111111111	0.	0.	0.1111111111111111
118	0.7239245418432168	0.8146214469656853	0.6666666666666666	0.7777777777777778	0.1111111111111111	0.	0.	0.1111111111111111
119	0.35544238084940327	0.27833829580104297	0.3333333333333333	0.2222222222222222	0.1111111111111111	0.	0.	0.1111111111111111
120	0.2847806628695538	0.061783733728479534	0.2222222222222222	0.	0.1111111111111111	0.	0.	0.1111111111111111
121	0.8389791967524637	0.5649658701108775	0.7777777777777778	0.5555555555555556	0.1111111111111111	0.	0.	0.1111111111111111
122	0.4659814769545311	0.9334099940525689	0.4444444444444444	0.8888888888888888	0.1111111111111111	0.	0.	0.1111111111111111
123	0.04622933266357699	0.7554312105573746	0.	0.6666666666666666	0.1111111111111111	0.	0.	0.1111111111111111
124	0.8915575577625169	0.1502065145897158	0.8888888888888888	0.1111111111111111	0.1111111111111111	0.	0.	0.1111111111111111
125	0.6258549067083543	0.3567194936524555	0.5555555555555556	0.3333333333333333	0.1111111111111111	0.	0.	0.1111111111111111
126	0.08771034220305957	0.13234486504747903	0.	0.1111111111111111	0.1111111111111111	0.	0.	0.1111111111111111
127	0.9328792253593657	0.43870158951075333	0.8888888888888888	0.3333333333333333	0.1111111111111111	0.	0.	0.1111111111111111
128	0.6390606495087392	0.7165159541506164	0.5555555555555556	0.6666666666666666	0.1111111111111111	0.	0.	0.1111111111111111
129	0.1618613481918006	0.8771287751897914	0.1111111111111111	0.7777777777777778	0.1111111111111111	0.	0.	0.1111111111111111
130	0.7640141450202617	0.24594572659957253	0.6666666666666666	0.2222222222222222	0.1111111111111111	0.	0.	0.1111111111111111
131	0.39538110833713125	0.5498792484703444	0.3333333333333333	0.4444444444444444	0.1111111111111111	0.	0.	0.1111111111111111
132	0.31319977761940204	0.6605161607753792	0.2222222222222222	0.5555555555555556	0.1111111111111111	0.	0.	0.1111111111111111
133	0.8783701232349296	0.9184898470010106	0.7777777777777778	0.8888888888888888	0.1111111111111111	0.	0.	0.1111111111111111
134	0.5169283694406432	0.030517689871929654	0.4444444444444444	0.	0.1111111111111111	0.	0.	0.1111111111111111
135	0.5510147425372746	0.789372029486718	0.4444444444444444	0.7777777777777778	0.1111111111111111	0.	0.	0.1111111111111111
136	0.2241780807485034	0.2885987891053434	0.2222222222222222	0.2222222222222222	0.1111111111111111	0.	0.	0.1111111111111111
137	0.7795611837142667	0.44896359538348185	0.7777777777777778	0.4444444444444444	0.1111111111111111	0.	0.	0.1111111111111111
138	0.5622702021489283	0.5769730616045623	0.5555555555555556	0.5555555555555556	0.1111111111111111	0.	0.	0.1111111111111111
139	0.025904459413692325	0.9462727116290092	0.	0.8888888888888888	0.1111111111111111	0.	0.	0.1111111111111111
140	0.9780034400813531	0.04668606896179584	0.8888888888888888	0.	0.1111111111111111	0.	0.	0.1111111111111111
141	0.43542556246511094	0.17023782136623142	0.3333333333333333	0.1111111111111111	0.1111111111111111	0.	0.	0.1111111111111111
142	0.2004902094891527	0.36978604832298034	0.1111111111111111	0.3333333333333333	0.1111111111111111	0.	0.	0.1111111111111111
143	0.6809003700713758	0.7767405197818539	0.6666666666666666	0.6666666666666666	0.1111111111111111	0.	0.	0.1111111111111111
144	0.3607856518571135	0.41537677683329755	0.3333333333333333	0.3333333333333333	0.1111111111111111	0.	0.	0.1111111111111111
145	0.11337953957996962	0.7345908250780889	0.1111111111111111	0.6666666666666666	0.1111111111111111	0.	0.	0.1111111111111111
146	0.7326168948866993	0.14117957762424901	0.6666666666666666	0.1111111111111111	0.1111111111111111	0.	0.	0.1111111111111111
147	0.47183017984368925	0.2530402291999929	0.4444444444444444	0.2222222222222222	0.1111111111111111	0.	0.	0.1111111111111111
148	0.2593819313120186	0.5244537062502478	0.2222222222222222	0.4444444444444444	0.1111111111111111	0.	0.	0.1111111111111111
149	0.8475285337838702	0.8608852107802004	0.7777777777777778	0.7777777777777778	0.1111111111111111	0.	0.	0.1111111111111111
150	0.6031358751051152	0.8978674245250531	0.5555555555555556	0.8888888888888888	0.1111111111111111	0.	0.	0.1111111111111111
151	0.05736531227529719	0.01071989595607922	0.	0.	0.1111111111111111	0.	0.	0.1111111111111111
152	0.9054739702559544	0.6405855507898379	0.8888888888888888	0.5555555555555556	0.1111111111111111	0.	0.	0.1111111111111111
153	0.6526544925884565	0.08300948516260154	0.5555555555555556	0.	0.1111111111111111	0.	0.	0.1111111111111111
154	0.10522201025528792	0.5930392709130399	0.	0.5555555555555556	0.1111111111111111	0.	0.	0.1111111111111111
155	0.941316265800284	0.9938759434068032	0.8888888888888888	0.8888888888888888	0.1111111111111111	0.	0.	0.1111111111111111
156	0.3821073834154737	0.7024672452640125	0.3333333333333333	0.6666666666666666	0.1111111111111111	0.	0.	0.1111111111111111
157	0.18315535535172311	0.20305832697798631	0.1111111111111111	0.1111111111111111	0.1111111111111111	0.	0.	0.1111111111111111
158	0.7763040104296944	0.38629316788663703	0.6666666666666666	0.3333333333333333	0.1111111111111111	0.	0.	0.1111111111111111
159	0.49024181750662826	0.5103899852510554	0.4444444444444444	0.4444444444444444	0.1111111111111111	0.	0.	0.1111111111111111
160	0.3331724968904953	0.8393375507131049	0.2222222222222222	0.7777777777777778	0.1111111111111111	0.	0.	0.1111111111111111
161	0.8630499328082775	0.3226240700966128	0.7777777777777778	0.2222222222222222	0.1111111111111111	0.	0.	0.1111111111111111
162	0.2745261647739028	0.29717829662849876	0.2222222222222222	0.2222222222222222	0.1111111111111111	0.	0.	0.1111111111111111
163	0.8170603809581515	0.48829601609772727	0.7777777777777778	0.4444444444444444	0.1111111111111111	0.	0.	0.1111111111111111
164	0.4566244559151336	0.8454977325682949	0.4444444444444444	0.7777777777777778	0.1111111111111111	0.	0.	0.1111111111111111
165	0.06996412451829137	0.9708286698280432	0.	0.8888888888888888	0.1111111111111111	0.	0.	0.1111111111111111
166	0.9164396852537142	0.09345354215378114	0.8888888888888888	0.	0.1111111111111111	0.	0.	0.1111111111111111
167	0.6154246839536668	0.6081518565908028	0.5555555555555556	0.5555555555555556	0.1111111111111111	0.	0.	0.1111111111111111
168	0.12498881544698072	0.40436849826322263	0.1111111111111111	0.3333333333333333	0.1111111111111111	0.	0.	0.1111111111111111
169	0.708031171440359	0.6733596855964596	0.6666666666666666	0.6666666666666666	0.1111111111111111	0.	0.	0.1111111111111111
170	0.3440217226095133	0.2164808729738263	0.3333333333333333	0.1111111111111111	0.1111111111111111	0.	0.	0.1111111111111111
171	0.15936610415047	0.7466482195610811	0.1111111111111111	0.6666666666666666	0.1111111111111111	0.	0.	0.1111111111111111
172	0.7414079993757551	0.17795918033304292	0.6666666666666666	0.1111111111111111	0.1111111111111111	0.	0.	0.1111111111111111
173	0.3832999171433429	0.3390947856313988	0.3333333333333333	0.3333333333333333	0.1111111111111111	0.	0.	0.1111111111111111
174	0.3006718874557683	0.4574040756700058	0.2222222222222222	0.4444444444444444	0.1111111111111111	0.	0.	0.1111111111111111
175	0.8723979928691898	0.7944317644662998	0.7777777777777778	0.7777777777777778	0.1111111111111111	0.	0.	0.1111111111111111
176	0.49682211481248406	0.2640201053830515	0.4444444444444444	0.2222222222222222	0.1111111111111111	0.	0.	0.1111111111111111
177	0.07577834635379856	0.055223241776800644	0.	0.	0.1111111111111111	0.	0.	0.1111111111111111
178	0.9514345019578974	0.5803538146550289	0.8888888888888888	0.5555555555555556	0.1111111111111111	0.	0.	0.1111111111111111
179	0.6598144210867141	0.9508724915854069	0.5555555555555556	0.8888888888888888	0.1111111111111111	0.	0.	0.1111111111111111
180	0.001162604145767486	0.6484698954576974	0.	0.5555555555555556	0.1111111111111111	0.	0.	0.1111111111111111
181	0.9884239257843348	0.9090114195448932	0.8888888888888888	0.8888888888888888	0.1111111111111111	0.	0.	0.1111111111111111
182	0.5739783241045882	0.014827970718571542	0.5555555555555556	0.	0.1111111111111111	0.	0.	0.1111111111111111
183	0.21584567339011682	0.11568404254771701	0.1111111111111111	0.1111111111111111	0.1111111111111111	0.	0.	0.1111111111111111
184	0.6972696084400086	0.42789839044022965	0.6666666666666666	0.3333333333333333	0.1111111111111111	0.	0.	0.1111111111111111
185	0.4078522247008297	0.7065498489936604	0.3333333333333333	0.6666666666666666	0.1111111111111111	0.	0.	0.1111111111111111
186	0.24019077025806623	0.872083401006359	0.2222222222222222	0.7777777777777778	0.1111111111111111	0.	0.	0.1111111111111111
187	0.7934379915220918	0.22638477095791054	0.7777777777777778	0.2222222222222222	0.1111111111111111	0.	0.	0.1111111111111111
188	0.5185427918862598	0.5409066633024668	0.4444444444444444	0.4444444444444444	0.1111111111111111	0.	0.	0.1111111111111111
189	0.45850972963556064	0.15934471395497102	0.4444444444444444	0.1111111111111111	0.1111111111111111	0.	0.	0.1111111111111111