0	0.6743214278822857	0.04845252862538546	0.6666666666666666	0.	0.1111111111111111	0.	0.	0.1111111111111111
1	0.009734378469246801	0.5342508064065415	0.	0.4444444444444444	0.1111111111111111	0.	0.	0.1111111111111111
2	0.42198329629386233	0.8754868219338464	0.3333333333333333	0.7777777777777778	0.1111111111111111	0.	0.	0.1111111111111111
3	0.14046648851002472	0.2854172210115953	0.1111111111111111	0.2222222222222222	0.1111111111111111	0.	0.	0.1111111111111111
4	0.5540792362859949	0.3940714116438999	0.4444444444444444	0.3333333333333333	0.1111111111111111	0.	0.	0.1111111111111111
5	0.836861697317201	0.7145657329100802	0.7777777777777778	0.6666666666666666	0.1111111111111111	0.	0.	0.1111111111111111
6	0.6628242266247307	0.2069114367361196	0.5555555555555556	0.1111111111111111	0.1111111111111111	0.	0.	0.1111111111111111
7	0.9031351342219109	0.5703247262519803	0.8888888888888888	0.5555555555555556	0.1111111111111111	0.	0.	0.1111111111111111
8	0.29792821566543437	0.9525672264242759	0.2222222222222222	0.8888888888888888	0.1111111111111111	0.	0.	0.1111111111111111
9	0.23851467924471773	0.624733886148873	0.2222222222222222	0.5555555555555556	0.1111111111111111	0.	0.	0.1111111111111111
10	0.5738386119962455	0.9995628419125763	0.5555555555555556	0.8888888888888888	0.1111111111111111	0.	0.	0.1111111111111111
11	0.9280951830781121	0.1387267517490537	0.8888888888888888	0.1111111111111111	0.1111111111111111	0.	0.	0.1111111111111111
12	0.3617644075263833	0.45899173219342393	0.3333333333333333	0.4444444444444444	0.1111111111111111	0.	0.	0.1111111111111111
13	0.7050779340686858	0.8130837181062632	0.6666666666666666	0.7777777777777778	0.1111111111111111	0.	0.	0.1111111111111111
14	0.04809006801565074	0.10317651355123181	0.	0.	0.1111111111111111	0.	0.	0.1111111111111111
15	0.8830262751883868	0.40817106173580137	0.7777777777777778	0.3333333333333333	0.1111111111111111	0.	0.	0.1111111111111111
16	0.163145766579905	0.7612851059098219	0.1111111111111111	0.6666666666666666	0.1111111111111111	0.	0.	0.1111111111111111
17	0.4814740279090746	0.3250739052506161	0.4444444444444444	0.2222222222222222	0.1111111111111111	0.	0.	0.1111111111111111
18	0.49273178390590144	0.6882795022576448	0.4444444444444444	0.6666666666666666	0.1111111111111111	0.	0.	0.1111111111111111
19	0.8087809608162809	0.24249240812179482	0.7777777777777778	0.2222222222222222	0.1111111111111111	0.	0.	0.1111111111111111
20	0.20232874587762623	0.35890838408049885	0.1111111111111111	0.3333333333333333	0.1111111111111111	0.	0.	0.1111111111111111
21	0.9722688629752191	0.9219562614992897	0.8888888888888888	0.8888888888888888	0.1111111111111111	0.	0.	0.1111111111111111
22	0.277538673662318	0.1518793455793024	0.2222222222222222	0.1111111111111111	0.1111111111111111	0.	0.	0.1111111111111111
23	0.6205776810804312	0.6664150735369773	0.5555555555555556	0.5555555555555556	0.1111111111111111	0.	0.	0.1111111111111111
24	0.1054492629066915	0.8386333485836884	0.	0.7777777777777778	0.1111111111111111	0.	0.	0.1111111111111111
25	0.38836238128507117	0.016082932739952913	0.3333333333333333	0.	0.1111111111111111	0.	0.	0.1111111111111111
26	0.7410840731244858	0.48917058780887906	0.6666666666666666	0.4444444444444444	0.1111111111111111	0.	0.	0.1111111111111111
27	0.06343587488132739	0.5905089986090024	0.	0.5555555555555556	0.1111111111111111	0.	0.	0.1111111111111111
28	0.3500943682236004	0.9348175723354682	0.3333333333333333	0.8888888888888888	0.1111111111111111	0.	0.	0.1111111111111111
29	0.7316366713893647	0.2184793389523943	0.6666666666666666	0.1111111111111111	0.1111111111111111	0.	0.	0.1111111111111111
30	0.4612464709715787	0.5464593226508472	0.4444444444444444	0.4444444444444444	0.1111111111111111	0.	0.	0.1111111111111111
31	0.8738034089880052	0.8787065079565268	0.7777777777777778	0.7777777777777778	0.1111111111111111	0.	0.	0.1111111111111111
32	0.1549714028332319	0.06015592445000158	0.1111111111111111	0.	0.1111111111111111	0.	0.	0.1111111111111111
33	0.956198218348058	0.4044199677489609	0.8888888888888888	0.3333333333333333	0.1111111111111111	0.	0.	0.1111111111111111
34	0.2325248454614731	0.7218785357873351	0.2222222222222222	0.6666666666666666	0.1111111111111111	0.	0.	0.1111111111111111
35	0.5626533861506742	0.2696527992181987	0.5555555555555556	0.2222222222222222	0.1111111111111111	0.	0.	0.1111111111111111
36	0.6169049317712605	0.7654628956222638	0.5555555555555556	0.6666666666666666	0.1111111111111111	0.	0.	0.1111111111111111
37	0.9891398774214031	0.30708122925321074	0.8888888888888888	0.2222222222222222	0.1111111111111111	0.	0.	0.1111111111111111
38	0.2681814478497204	0.42173834968926144	0.2222222222222222	0.3333333333333333	0.1111111111111111	0.	0.	0.1111111111111111
39	0.776665933294681	0.9647817060427419	0.6666666666666666	0.8888888888888888	0.1111111111111111	0.	0.	0.1111111111111111
40	0.09515074545614272	0.12046197174667242	0.	0.1111111111111111	0.1111111111111111	0.	0.	0.1111111111111111
41	0.3735571180215338	0.5990314957245332	0.3333333333333333	0.5555555555555556	0.1111111111111111	0.	0.	0.1111111111111111
42	0.1895471924821198	0.7889537630175948	0.1111111111111111	0.7777777777777778	0.1111111111111111	0.	0.	0.1111111111111111
43	0.5109094483986709	0.0863822658245281	0.4444444444444444	0.	0.1111111111111111	0.	0.	0.1111111111111111
44	0.7956854204132366	0.47203320730928094	0.7777777777777778	0.4444444444444444	0.1111111111111111	0.	0.	0.1111111111111111
45	0.8189042698427514	0.030260637557555713	0.7777777777777778	0.	0.1111111111111111	0.	0.	0.1111111111111111
46	0.1337511200481019	0.5027677709287768	0.1111111111111111	0.4444444444444444	0.1111111111111111	0.	0.	0.1111111111111111
47	0.53453362056612	0.8442564980948475	0.4444444444444444	0.7777777777777778	0.1111111111111111	0.	0.	0.1111111111111111
48	0.3232844739917718	0.2565061231613557	0.2222222222222222	0.2222222222222222	0.1111111111111111	0.	0.	0.1111111111111111
49	0.6494167994300374	0.33844539646946764	0.5555555555555556	0.3333333333333333	0.1111111111111111	0.	0.	0.1111111111111111
50	0.8895277201855304	0.7025090103929258	0.8888888888888888	0.6666666666666666	0.1111111111111111	0.	0.	0.1111111111111111
51	0.40821807267228283	0.1659686985045681	0.3333333333333333	0.1111111111111111	0.1111111111111111	0.	0.	0.1111111111111111
52	0.7018796210336723	0.639668660717976	0.6666666666666666	0.5555555555555556	0.1111111111111111	0.	0.	0.1111111111111111
53	0.031222297245788334	0.8953895655563363	0.	0.8888888888888888	0.1111111111111111	0.	0.	0.1111111111111111
54	0.4001983471073811	0.731586719634404	0.3333333333333333	0.6666666666666666	0.1111111111111111	0.	0.	0.1111111111111111
55	0.7560669057266441	0.28066587189025344	0.6666666666666666	0.2222222222222222	0.1111111111111111	0.	0.	0.1111111111111111
56	0.08395086714167045	0.3721513646292121	0.	0.3333333333333333	0.1111111111111111	0.	0.	0.1111111111111111
57	0.7857734080759989	0.9394873614957417	0.7777777777777778	0.8888888888888888	0.1111111111111111	0.	0.	0.1111111111111111
58	0.21196884521682252	0.18567056133850132	0.1111111111111111	0.1111111111111111	0.1111111111111111	0.	0.	0.1111111111111111
59	0.49967386899526284	0.5675297561938359	0.4444444444444444	0.5555555555555556	0.1111111111111111	0.	0.	0.1111111111111111
60	0.285213874340721	0.8625325802012501	0.2222222222222222	0.7777777777777778	0.1111111111111111	0.	0.	0.1111111111111111
61	0.595285457398718	0.062192954900740935	0.5555555555555556	0.	0.1111111111111111	0.	0.	0.1111111111111111
62	0.9810067883804324	0.5199846077319881	0.8888888888888888	0.4444444444444444	0.1111111111111111	0.	0.	0.1111111111111111
63	0.9191763870117189	0.09214731111790357	0.8888888888888888	0.	0.1111111111111111	0.	0.	0.1111111111111111
64	0.3152776138624236	0.45519782942266307	0.2222222222222222	0.4444444444444444	0.1111111111111111	0.	0.	0.1111111111111111
65	0.6320317027252872	0.7971437893329042	0.5555555555555556	0.7777777777777778	0.1111111111111111	0.	0.	0.1111111111111111
66	0.022340558245488154	0.3174197411467656	0.	0.2222222222222222	0.1111111111111111	0.	0.	0.1111111111111111
67	0.44425483048385367	0.43943995779049605	0.3333333333333333	0.3333333333333333	0.1111111111111111	0.	0.	0.1111111111111111
68	0.682246224721481	0.7497912575983215	0.6666666666666666	0.6666666666666666	0.1111111111111111	0.	0.	0.1111111111111111
69	0.5299947158964018	0.1307919580198902	0.4444444444444444	0.1111111111111111	0.1111111111111111	0.	0.	0.1111111111111111
70	0.8404780729085293	0.607469568635368	0.7777777777777778	0.5555555555555556	0.1111111111111111	0.	0.	0.1111111111111111
71	0.1111684398636267	0.9788680923377804	0.1111111111111111	0.8888888888888888	0.1111111111111111	0.	0.	0.1111111111111111
72	0.1730801998617752	0.6471677237493757	0.1111111111111111	0.5555555555555556	0.1111111111111111	0.	0.	0.1111111111111111
73	0.4550873646058853	0.908866310200061	0.4444444444444444	0.8888888888888888	0.1111111111111111	0.	0.	0.1111111111111111
74	0.8556173685830368	0.18016322914024652	0.7777777777777778	0.1111111111111111	0.1111111111111111	0.	0.	0.1111111111111111
75	0.5875261439773776	0.51534994836063	0.5555555555555556	0.4444444444444444	0.1111111111111111	0.	0.	0.1111111111111111
76	0.940127421431584	0.8222206105366824	0.8888888888888888	0.7777777777777778	0.1111111111111111	0.	0.	0.1111111111111111
77	0.252044584904061	0.0070667506694515585	0.2222222222222222	0.	0.1111111111111111	0.	0.	0.1111111111111111
78	0.7279141880043074	0.3576223877342052	0.6666666666666666	0.3333333333333333	0.1111111111111111	0.	0.	0.1111111111111111
79	0.05341814020579588	0.6689153568918929	0.	0.6666666666666666	0.1111111111111111	0.	0.	0.1111111111111111
80	0.3454972640850701	0.233494148008264	0.3333333333333333	0.2222222222222222	0.1111111111111111	0.	0.	0.1111111111111111
81	0.24265445943756822	0.1272375306235632	0.2222222222222222	0.1111111111111111	0.1111111111111111	0.	0.	0.1111111111111111
82	0.5782105284232055	0.6156030766870464	0.5555555555555556	0.5555555555555556	0.1111111111111111	0.	0.	0.1111111111111111
83	0.9339147522473961	0.9842994037760697	0.8888888888888888	0.8888888888888888	0.1111111111111111	0.	0.	0.1111111111111111
84	0.36347190111224786	0.08854446690522522	0.3333333333333333	0.	0.1111111111111111	0.	0.	0.1111111111111111
85	0.7101646087695688	0.4512446707484281	0.6666666666666666	0.4444444444444444	0.1111111111111111	0.	0.	0.1111111111111111
86	0.0380391101789835	0.7930153086629	0.	0.7777777777777778	0.1111111111111111	0.	0.	0.1111111111111111
87	0.8885271045469497	0.3139710859914451	0.7777777777777778	0.2222222222222222	0.1111111111111111	0.	0.	0.1111111111111111
88	0.1668279199692336	0.4359307482745619	0.1111111111111111	0.3333333333333333	0.1111111111111111	0.	0.	0.1111111111111111
89	0.4715328784103965	0.7449950313116593	0.4444444444444444	0.6666666666666666	0.1111111111111111	0.	0.	0.1111111111111111
90	0.48370589145583365	0.3511922674796892	0.4444444444444444	0.3333333333333333	0.1111111111111111	0.	0.	0.1111111111111111
91	0.8117010103028737	0.6777409364118583	0.7777777777777778	0.6666666666666666	0.1111111111111111	0.	0.	0.1111111111111111
92	0.20871564091868844	0.22862128061929463	0.1111111111111111	0.2222222222222222	0.1111111111111111	0.	0.	0.1111111111111111
93	0.9660223554499033	0.6426914082663984	0.8888888888888888	0.5555555555555556	0.1111111111111111	0.	0.	0.1111111111111111
94	0.2820296665655527	0.9045312322997284	0.2222222222222222	0.8888888888888888	0.1111111111111111	0.	0.	0.1111111111111111
95	0.6254083213101997	0.17465219209577393	0.5555555555555556	0.1111111111111111	0.1111111111111111	0.	0.	0.1111111111111111
96	0.1092629366159654	0.5129317902440622	0.	0.4444444444444444	0.1111111111111111	0.	0.	0.1111111111111111
97	0.39385605562711135	0.8175825044365856	0.3333333333333333	0.7777777777777778	0.1111111111111111	0.	0.	0.1111111111111111
98	0.7487311940627213	0.0038325911393223533	0.6666666666666666	0.	0.1111111111111111	0.	0.	0.1111111111111111
99	0.6767488937151525	0.858872166326409	0.6666666666666666	0.7777777777777778	0.1111111111111111	0.	0.	0.1111111111111111
100	0.0009479132116835463	0.07153079178869483	0.	0.	0.1111111111111111	0.	0.	0.1111111111111111
101	0.42476643166558664	0.528316194276791	0.3333333333333333	0.4444444444444444	0.1111111111111111	0.	0.	0.1111111111111111
102	0.14556214483879132	0.7401181631017627	0.1111111111111111	0.6666666666666666	0.1111111111111111	0.	0.	0.1111111111111111
103	0.5462607459909881	0.2779954142624949	0.4444444444444444	0.2222222222222222	0.1111111111111111	0.	0.	0.1111111111111111
104	0.8300509294953681	0.3786461080362049	0.7777777777777778	0.3333333333333333	0.1111111111111111	0.	0.	0.1111111111111111
105	0.655944541435959	0.9469090013288722	0.5555555555555556	0.8888888888888888	0.1111111111111111	0.	0.	0.1111111111111111
106	0.9075618524312654	0.19538324331284052	0.8888888888888888	0.1111111111111111	0.1111111111111111	0.	0.	0.1111111111111111
107	0.3006025674255619	0.5614553226860098	0.2222222222222222	0.5555555555555556	0.1111111111111111	0.	0.	0.1111111111111111
108	0.6054350161124287	0.4175942778631239	0.5555555555555556	0.3333333333333333	0.1111111111111111	0.	0.	0.1111111111111111
109	0.9958154372849048	0.757056356923859	0.8888888888888888	0.6666666666666666	0.1111111111111111	0.	0.	0.1111111111111111
110	0.2630396925995654	0.33009175636724447	0.2222222222222222	0.2222222222222222	0.1111111111111111	0.	0.	0.1111111111111111
111	0.7673535708811382	0.6189788919501363	0.6666666666666666	0.5555555555555556	0.1111111111111111	0.	0.	0.1111111111111111
112	0.08668100067022183	0.9925211243366465	0.	0.8888888888888888	0.1111111111111111	0.	0.	0.1111111111111111
113	0.3752565549004818	0.14761123367776594	0.3333333333333333	0.1111111111111111	0.1111111111111111	0.	0.	0.1111111111111111
114	0.1971702551505134	0.46520482210910297	0.1111111111111111	0.4444444444444444	0.1111111111111111	0.	0.	0.1111111111111111
115	0.5181757204379555	0.8078595898249805	0.4444444444444444	0.7777777777777778	0.1111111111111111	0.	0.	0.1111111111111111
116	0.7990938075210232	0.09942222234921604	0.7777777777777778	0.	0.1111111111111111	0.	0.	0.1111111111111111
117	0.8207212929997275	0.8330598273202497	0.7777777777777778	0.7777777777777778	0.1111111111111111	0.	0.	0.1111111111111111
118	0.1252589155999267	0.02094459094719347	0.1111111111111111	0.	0.1111111111111111	0.	0.	0.1111111111111111
119	0.5374204202194376	0.48392117950168617	0.4444444444444444	0.4444444444444444	0.1111111111111111	0.	0.	0.1111111111111111
120	0.32705631976354593	0.6850356228836415	0.2222222222222222	0.6666666666666666	0.1111111111111111	0.	0.	0.1111111111111111
121	0.6504391313525325	0.23660882237611003	0.5555555555555556	0.2222222222222222	0.1111111111111111	0.	0.	0.1111111111111111
122	0.896173273031687	0.36980447188825205	0.8888888888888888	0.3333333333333333	0.1111111111111111	0.	0.	0.1111111111111111
123	0.41159770721367295	0.919572678219057	0.3333333333333333	0.8888888888888888	0.1111111111111111	0.	0.	0.1111111111111111
124	0.6932474016193122	0.15796165597220133	0.6666666666666666	0.1111111111111111	0.1111111111111111	0.	0.	0.1111111111111111
125	0.035554175349770935	0.6596044631668065	0.	0.5555555555555556	0.1111111111111111	0.	0.	0.1111111111111111
126	0.0678040400009235	0.20270619192781	0.	0.1111111111111111	0.1111111111111111	0.	0.	0.1111111111111111
127	0.3577340106380727	0.579909238271254	0.3333333333333333	0.5555555555555556	0.1111111111111111	0.	0.	0.1111111111111111
128	0.735599897505679	0.9606918147962658	0.6666666666666666	0.8888888888888888	0.1111111111111111	0.	0.	0.1111111111111111
129	0.46627017705302626	0.04208029551753178	0.4444444444444444	0.	0.1111111111111111	0.	0.	0.1111111111111111
130	0.8669461301172089	0.5411880345853367	0.7777777777777778	0.4444444444444444	0.1111111111111111	0.	0.	0.1111111111111111
131	0.15861440926527762	0.8696160611853099	0.1111111111111111	0.7777777777777778	0.1111111111111111	0.	0.	0.1111111111111111
132	0.96234889373649	0.29395752823318894	0.8888888888888888	0.2222222222222222	0.1111111111111111	0.	0.	0.1111111111111111
133	0.22493987404987253	0.38973350993834505	0.2222222222222222	0.3333333333333333	0.1111111111111111	0.	0.	0.1111111111111111
134	0.5672383518845506	0.7115680150136132	0.5555555555555556	0.6666666666666666	0.1111111111111111	0.	0.	0.1111111111111111
135	0.9228321014276559	0.7859158157912157	0.8888888888888888	0.7777777777777778	0.1111111111111111	0.	0.	0.1111111111111111
136	0.31968253835262017	0.07882317413178079	0.2222222222222222	0.	0.1111111111111111	0.	0.	0.1111111111111111
137	0.6351345131533989	0.48103935205140896	0.5555555555555556	0.4444444444444444	0.1111111111111111	0.	0.	0.1111111111111111
138	0.01251728497680634	0.7771052242928742	0.	0.6666666666666666	0.1111111111111111	0.	0.	0.1111111111111111
139	0.43246210536204593	0.3010718456520938	0.3333333333333333	0.2222222222222222	0.1111111111111111	0.	0.	0.1111111111111111
140	0.6841203752993389	0.43101561156720347	0.6666666666666666	0.3333333333333333	0.1111111111111111	0.	0.	0.1111111111111111
141	0.5215292567210267	0.9714288979348914	0.4444444444444444	0.8888888888888888	0.1111111111111111	0.	0.	0.1111111111111111
142	0.8453468250444889	0.11682463873681881	0.7777777777777778	0.1111111111111111	0.1111111111111111	0.	0.	0.1111111111111111
143	0.11890612906295381	0.5957670245984331	0.1111111111111111	0.5555555555555556	0.1111111111111111	0.	0.	0.1111111111111111
144	0.17777245384665244	0.1629047700331271	0.1111111111111111	0.1111111111111111	0.1111111111111111	0.	0.	0.1111111111111111
145	0.4455103844546539	0.6378177243658031	0.4444444444444444	0.5555555555555556	0.1111111111111111	0.	0.	0.1111111111111111
146	0.8584634717138051	0.8905407702034744	0.7777777777777778	0.8888888888888888	0.1111111111111111	0.	0.	0.1111111111111111
147	0.588510135989908	0.02816682384257345	0.5555555555555556	0.	0.1111111111111111	0.	0.	0.1111111111111111
148	0.9452894518097279	0.49846347525861845	0.8888888888888888	0.4444444444444444	0.1111111111111111	0.	0.	0.1111111111111111
149	0.2567933192953389	0.8405168344103764	0.2222222222222222	0.7777777777777778	0.1111111111111111	0.	0.	0.1111111111111111
150	0.7169403870463168	0.25393689920892826	0.6666666666666666	0.2222222222222222	0.1111111111111111	0.	0.	0.1111111111111111
151	0.055337633420828196	0.3351253173740466	0.	0.3333333333333333	0.1111111111111111	0.	0.	0.1111111111111111
152	0.33505219613376375	0.6967898790367453	0.3333333333333333	0.6666666666666666	0.1111111111111111	0.	0.	0.1111111111111111
153	0.40378789999066533	0.402234823465932	0.3333333333333333	0.3333333333333333	0.1111111111111111	0.	0.	0.1111111111111111
154	0.7577015258650057	0.7163989615427903	0.6666666666666666	0.6666666666666666	0.1111111111111111	0.	0.	0.1111111111111111
155	0.07708512545912358	0.2644219504181498	0.	0.2222222222222222	0.1111111111111111	0.	0.	0.1111111111111111
156	0.7901179072643213	0.588398199903499	0.7777777777777778	0.5555555555555556	0.1111111111111111	0.	0.	0.1111111111111111
157	0.21671878243555331	0.9317051556351735	0.1111111111111111	0.8888888888888888	0.1111111111111111	0.	0.	0.1111111111111111
158	0.5033877467435647	0.2172053855072871	0.4444444444444444	0.1111111111111111	0.1111111111111111	0.	0.	0.1111111111111111
159	0.2907278513432813	0.5540971160837771	0.2222222222222222	0.4444444444444444	0.1111111111111111	0.	0.	0.1111111111111111
160	0.5971483962136723	0.8848849550649346	0.5555555555555556	0.7777777777777778	0.1111111111111111	0.	0.	0.1111111111111111
161	0.9839809917745471	0.054474379300746445	0.8888888888888888	0.	0.1111111111111111	0.	0.	0.1111111111111111
162	0.4889853979818811	0.24892041439415633	0.4444444444444444	0.2222222222222222	0.1111111111111111	0.	0.	0.1111111111111111
163	0.8033475947628572	0.3422914140196648	0.7777777777777778	0.3333333333333333	0.1111111111111111	0.	0.	0.1111111111111111
164	0.1976723598976546	0.6943829533324795	0.1111111111111111	0.6666666666666666	0.1111111111111111	0.	0.	0.1111111111111111
165	0.9679551554813784	0.17187065963359524	0.8888888888888888	0.1111111111111111	0.1111111111111111	0.	0.	0.1111111111111111
166	0.2751425458725975	0.6303343196010817	0.2222222222222222	0.5555555555555556	0.1111111111111111	0.	0.	0.1111111111111111
167	0.629542180288078	0.8975218792141202	0.5555555555555556	0.8888888888888888	0.1111111111111111	0.	0.	0.1111111111111111
168	0.09898708790282901	0.03637081001154795	0.	0.	0.1111111111111111	0.	0.	0.1111111111111111
169	0.38467710467424454	0.494354727669897	0.3333333333333333	0.4444444444444444	0.1111111111111111	0.	0.	0.1111111111111111
170	0.7502882516193751	0.8495546914659953	0.6666666666666666	0.7777777777777778	0.1111111111111111	0.	0.	0.1111111111111111
171	0.6700646241075117	0.5489756144518211	0.6666666666666666	0.4444444444444444	0.1111111111111111	0.	0.	0.1111111111111111
172	0.0071825309855170485	0.8841760990773688	0.	0.7777777777777778	0.1111111111111111	0.	0.	0.1111111111111111
173	0.4314559513827538	0.052612613199539214	0.3333333333333333	0.	0.1111111111111111	0.	0.	0.1111111111111111
174	0.1390632586462578	0.39715510072915466	0.1111111111111111	0.3333333333333333	0.1111111111111111	0.	0.	0.1111111111111111
175	0.549378699311211	0.7269414327060367	0.4444444444444444	0.6666666666666666	0.1111111111111111	0.	0.	0.1111111111111111
176	0.8352191796443684	0.26291721843687355	0.7777777777777778	0.2222222222222222	0.1111111111111111	0.	0.	0.1111111111111111
177	0.6622318607762983	0.5831451616041573	0.5555555555555556	0.5555555555555556	0.1111111111111111	0.	0.	0.1111111111111111
178	0.9103557951818428	0.9268585396542275	0.8888888888888888	0.8888888888888888	0.1111111111111111	0.	0.	0.1111111111111111
179	0.3052132046635251	0.21129182543913763	0.2222222222222222	0.1111111111111111	0.1111111111111111	0.	0.	0.1111111111111111
180	0.24485693975089	0.9699078296983583	0.2222222222222222	0.8888888888888888	0.1111111111111111	0.	0.	0.1111111111111111
181	0.570329443779108	0.112640889091783	0.5555555555555556	0.1111111111111111	0.1111111111111111	0.	0.	0.1111111111111111
182	0.9357809115080988	0.6008628951647074	0.8888888888888888	0.5555555555555556	0.1111111111111111	0.	0.	0.1111111111111111
183	0.3670723086959227	0.7812908504519835	0.3333333333333333	0.7777777777777778	0.1111111111111111	0.	0.	0.1111111111111111
184	0.712556603238056	0.07479083878120173	0.6666666666666666	0.	0.1111111111111111	0.	0.	0.1111111111111111
185	0.04488327668183806	0.4770348116513787	0.	0.4444444444444444	0.1111111111111111	0.	0.	0.1111111111111111
186	0.8782921545483879	0.7707815336185452	0.7777777777777778	0.6666666666666666	0.1111111111111111	0.	0.	0.1111111111111111
187	0.17088062164931092	0.2978810309298501	0.1111111111111111	0.2222222222222222	0.1111111111111111	0.	0.	0.1111111111111111
188	0.47421331572029146	0.42436454791286654	0.4444444444444444	0.3333333333333333	0.1111111111111111	0.	0.	0.1111111111111111
189	0.8267659053347934	0.5097823672407785	0.7777777777777778	0.4444444444444444	0.1111111111111111	0.	0.	0.1111111111111111
190	0.12771020395533772	0.8242931252576751	0.1111111111111111	0.7777777777777778	0.1111111111111111	0.	0.	0.1111111111111111
191	0.5406382572605756	0.01065675611871593	0.4444444444444444	0.	0.1111111111111111	0.	0.	0.1111111111111111
192	0.3319806291057227	0.3469590814542594	0.2222222222222222	0.3333333333333333	0.1111111111111111	0.	0.	0.1111111111111111
193	0.6452928926017644	0.674773253925659	0.5555555555555556	0.6666666666666666	0.1111111111111111	0.	0.	0.1111111111111111
194	0.8985516750337212	0.22469608209079514	0.8888888888888888	0.2222222222222222	0.1111111111111111	0.	0.	0.1111111111111111
195	0.4171608685018893	0.6537041892657017	0.3333333333333333	0.5555555555555556	0.1111111111111111	0.	0.	0.1111111111111111
196	0.6990001596602875	0.9097702780505241	0.6666666666666666	0.8888888888888888	0.1111111111111111	0.	0.	0.1111111111111111
197	0.028419567315828433	0.18231442065006534	0.	0.1111111111111111	0.1111111111111111	0.	0.	0.1111111111111111
198	0.07221818186630118	0.942523297986958	0.	0.8888888888888888	0.1111111111111111	0.	0.	0.1111111111111111
199	0.3491625004548137	0.1903322585158026	0.3333333333333333	0.1111111111111111	0.1111111111111111	0.	0.	0.1111111111111111
200	0.7399568809760774	0.5595163226726849	0.6666666666666666	0.5555555555555556	0.1111111111111111	0.	0.	0.1111111111111111
201	0.45679127896270527	0.8525677914434379	0.4444444444444444	0.7777777777777778	0.1111111111111111	0.	0.	0.1111111111111111
202	0.8711156678138415	0.06948724731317278	0.7777777777777778	0.	0.1111111111111111	0.	0.	0.1111111111111111
203	0.14925916321374533	0.5258825645985216	0.1111111111111111	0.4444444444444444	0.1111111111111111	0.	0.	0.1111111111111111
204	0.9506977064739943	0.7349073364745732	0.8888888888888888	0.6666666666666666	0.1111111111111111	0.	0.	0.1111111111111111
205	0.2298350866690137	0.2745635023276565	0.2222222222222222	0.2222222222222222	0.1111111111111111	0.	0.	0.1111111111111111
206	0.557573739988749	0.3766513279752395	0.5555555555555556	0.3333333333333333	0.1111111111111111	0.	0.	0.1111111111111111
207	0.6105457086447486	0.31147304395664016	0.5555555555555556	0.2222222222222222	0.1111111111111111	0.	0.	0.1111111111111111
208	0.9998987775097599	0.44418958698903505	0.8888888888888888	0.3333333333333333	0.1111111111111111	0.	0.	0.1111111111111111
209	0.2637650663850151	0.7423189269338482	0.2222222222222222	0.6666666666666666	0.1111111111111111	0.	0.	0.1111111111111111
210	0.7719820500596534	0.1328947137847425	0.6666666666666666	0.1111111111111111	0.1111111111111111	0.	0.	0.1111111111111111
211	0.09187078297933456	0.6120238450613628	0.	0.5555555555555556	0.1111111111111111	0.	0.	0.1111111111111111
212	0.38088303842908017	0.9828219023284543	0.3333333333333333	0.8888888888888888	0.1111111111111111	0.	0.	0.1111111111111111
213	0.185800367758385	0.09839322153145082	0.1111111111111111	0.	0.1111111111111111	0.	0.	0.1111111111111111
214	0.5090074985683062	0.4466094762134964	0.4444444444444444	0.4444444444444444	0.1111111111111111	0.	0.	0.1111111111111111