0	0.9342491073052155	0.01962615267533429	0.8888888888888888	0.	0.1111111111111111	0.	0.	0.1111111111111111
1	0.27406793999822077	0.37455264874577493	0.2222222222222222	0.3333333333333333	0.1111111111111111	0.	0.	0.1111111111111111
2	0.5467802968985465	0.9933775073694326	0.4444444444444444	0.8888888888888888	0.1111111111111111	0.	0.	0.1111111111111111
3	0.7905371640441728	0.553061381841372	0.7777777777777778	0.4444444444444444	0.1111111111111111	0.	0.	0.1111111111111111
4	0.1690638523078559	0.7162358958253239	0.1111111111111111	0.6666666666666666	0.1111111111111111	0.	0.	0.1111111111111111
5	0.40097282172050197	0.18597043190110343	0.3333333333333333	0.1111111111111111	0.1111111111111111	0.	0.	0.1111111111111111
6	0.6827184153735694	0.8133105534677423	0.6666666666666666	0.7777777777777778	0.1111111111111111	0.	0.	0.1111111111111111
7	0.02798102313754156	0.3259340404511578	0.	0.2222222222222222	0.1111111111111111	0.	0.	0.1111111111111111
8	0.5729341683492293	0.5656777400502085	0.5555555555555556	0.5555555555555556	0.1111111111111111	0.	0.	0.1111111111111111
9	0.7392841502505046	0.1324727089141294	0.6666666666666666	0.1111111111111111	0.1111111111111111	0.	0.	0.1111111111111111
10	0.05760977361903714	0.4790969603744077	0.	0.4444444444444444	0.1111111111111111	0.	0.	0.1111111111111111
11	0.6075636128785125	0.7752642228824748	0.5555555555555556	0.6666666666666666	0.1111111111111111	0.	0.	0.1111111111111111
12	0.9937304658143674	0.5940144826293204	0.8888888888888888	0.5555555555555556	0.1111111111111111	0.	0.	0.1111111111111111
13	0.3194514750268323	0.8395611217488638	0.2222222222222222	0.7777777777777778	0.1111111111111111	0.	0.	0.1111111111111111
14	0.46972742321844524	0.22743799524070432	0.4444444444444444	0.2222222222222222	0.1111111111111111	0.	0.	0.1111111111111111
15	0.8224790119450808	0.8895926418938916	0.7777777777777778	0.8888888888888888	0.1111111111111111	0.	0.	0.1111111111111111
16	0.2211431646817213	0.0737813077648904	0.1111111111111111	0.	0.1111111111111111	0.	0.	0.1111111111111111
17	0.43380919811565943	0.4269356853762063	0.3333333333333333	0.3333333333333333	0.1111111111111111	0.	0.	0.1111111111111111
18	0.8807354558886018	0.26079382531916984	0.7777777777777778	0.2222222222222222	0.1111111111111111	0.	0.	0.1111111111111111
19	0.1261736082316493	0.6578728450609471	0.1111111111111111	0.5555555555555556	0.1111111111111111	0.	0.	0.1111111111111111
20	0.3485301401633751	0.8567466893402568	0.3333333333333333	0.7777777777777778	0.1111111111111111	0.	0.	0.1111111111111111
21	0.7657299061089841	0.3595077819094556	0.6666666666666666	0.3333333333333333	0.1111111111111111	0.	0.	0.1111111111111111
22	0.1088033851164404	0.9384263747599575	0.	0.8888888888888888	0.1111111111111111	0.	0.	0.1111111111111111
23	0.6644289102978582	0.10906703319279881	0.5555555555555556	0.	0.1111111111111111	0.	0.	0.1111111111111111
24	0.914015072479384	0.6987158294907148	0.8888888888888888	0.6666666666666666	0.1111111111111111	0.	0.	0.1111111111111111
25	0.22889588234107744	0.15423972409815773	0.2222222222222222	0.1111111111111111	0.1111111111111111	0.	0.	0.1111111111111111
26	0.49376322479423645	0.4975104530416304	0.4444444444444444	0.4444444444444444	0.1111111111111111	0.	0.	0.1111111111111111
27	0.8904157793953605	0.1687097994448094	0.8888888888888888	0.1111111111111111	0.1111111111111111	0.	0.	0.1111111111111111
28	0.239982774891392	0.507829297243664	0.2222222222222222	0.4444444444444444	0.1111111111111111	0.	0.	0.1111111111111111
29	0.4965997853217997	0.6777250372355328	0.4444444444444444	0.6666666666666666	0.1111111111111111	0.	0.	0.1111111111111111
30	0.8520950157250633	0.6395325175139787	0.7777777777777778	0.5555555555555556	0.1111111111111111	0.	0.	0.1111111111111111
31	0.14070713573781424	0.8751827982610044	0.1111111111111111	0.7777777777777778	0.1111111111111111	0.	0.	0.1111111111111111
32	0.36085143739863834	0.2815665470220738	0.3333333333333333	0.2222222222222222	0.1111111111111111	0.	0.	0.1111111111111111
33	0.7410309387810067	0.9573637607311299	0.6666666666666666	0.8888888888888888	0.1111111111111111	0.	0.	0.1111111111111111
34	0.08475967310030422	0.08142100524442493	0.	0.	0.1111111111111111	0.	0.	0.1111111111111111
35	0.630097633616206	0.3442024340982475	0.5555555555555556	0.3333333333333333	0.1111111111111111	0.	0.	0.1111111111111111
36	0.699037047229236	0.302420218668404	0.6666666666666666	0.2222222222222222	0.1111111111111111	0.	0.	0.1111111111111111
37	0.01056571636302901	0.5727340464260612	0.	0.5555555555555556	0.1111111111111111	0.	0.	0.1111111111111111
38	0.5924641103153772	0.7877114599377835	0.5555555555555556	0.7777777777777778	0.1111111111111111	0.	0.	0.1111111111111111
39	0.9451251953102907	0.38680792039025763	0.8888888888888888	0.3333333333333333	0.1111111111111111	0.	0.	0.1111111111111111
40	0.287245327733127	0.9744154531107759	0.2222222222222222	0.8888888888888888	0.1111111111111111	0.	0.	0.1111111111111111
41	0.5209004326390526	0.03176679864927501	0.4444444444444444	0.	0.1111111111111111	0.	0.	0.1111111111111111
42	0.803021822971612	0.7296976206129356	0.7777777777777778	0.6666666666666666	0.1111111111111111	0.	0.	0.1111111111111111
43	0.18317068150724472	0.2016966566095407	0.1111111111111111	0.1111111111111111	0.1111111111111111	0.	0.	0.1111111111111111
44	0.3738154204848986	0.5296108151884554	0.3333333333333333	0.4444444444444444	0.1111111111111111	0.	0.	0.1111111111111111
45	0.8339737249501363	0.04347211916989416	0.7777777777777778	0.	0.1111111111111111	0.	0.	0.1111111111111111
46	0.1902173024548873	0.4359696353935822	0.1111111111111111	0.3333333333333333	0.1111111111111111	0.	0.	0.1111111111111111
47	0.41138528513223094	0.9091112327136972	0.3333333333333333	0.8888888888888888	0.1111111111111111	0.	0.	0.1111111111111111
48	0.7155817375127692	0.44515037940253777	0.6666666666666666	0.4444444444444444	0.1111111111111111	0.	0.	0.1111111111111111
49	0.07130403128128483	0.7507940844433071	0.	0.6666666666666666	0.1111111111111111	0.	0.	0.1111111111111111
50	0.6288287995011024	0.1462215102412924	0.5555555555555556	0.1111111111111111	0.1111111111111111	0.	0.	0.1111111111111111
51	0.9675392069072183	0.824122015739166	0.8888888888888888	0.7777777777777778	0.1111111111111111	0.	0.	0.1111111111111111
52	0.324232148874983	0.24563506672634103	0.2222222222222222	0.2222222222222222	0.1111111111111111	0.	0.	0.1111111111111111
53	0.45423617747795475	0.6052497299215719	0.4444444444444444	0.5555555555555556	0.1111111111111111	0.	0.	0.1111111111111111
54	0.9802290356753263	0.24792542657701314	0.8888888888888888	0.2222222222222222	0.1111111111111111	0.	0.	0.1111111111111111
55	0.303481466102842	0.628686121622924	0.2222222222222222	0.5555555555555556	0.1111111111111111	0.	0.	0.1111111111111111
56	0.45797285818475825	0.8372953518900409	0.4444444444444444	0.7777777777777778	0.1111111111111111	0.	0.	0.1111111111111111
57	0.8505657531189581	0.4103227668994038	0.7777777777777778	0.3333333333333333	0.1111111111111111	0.	0.	0.1111111111111111
58	0.20648434781155833	0.9232519140204792	0.1111111111111111	0.8888888888888888	0.1111111111111111	0.	0.	0.1111111111111111
59	0.43048500462762057	0.05855120722160188	0.3333333333333333	0.	0.1111111111111111	0.	0.	0.1111111111111111
60	0.7206247912200637	0.7630714819181045	0.6666666666666666	0.6666666666666666	0.1111111111111111	0.	0.	0.1111111111111111
61	0.04005075735682116	0.1157679634233284	0.	0.1111111111111111	0.1111111111111111	0.	0.	0.1111111111111111
62	0.595294557760642	0.45935823664366576	0.5555555555555556	0.4444444444444444	0.1111111111111111	0.	0.	0.1111111111111111
63	0.7622338657468373	0.09714956849722353	0.6666666666666666	0.	0.1111111111111111	0.	0.	0.1111111111111111
64	0.09451894786080867	0.3468742081251499	0.	0.3333333333333333	0.1111111111111111	0.	0.	0.1111111111111111
65	0.6434150483627795	0.9306236055402153	0.5555555555555556	0.8888888888888888	0.1111111111111111	0.	0.	0.1111111111111111
66	0.9097822607242989	0.4822505769263364	0.8888888888888888	0.4444444444444444	0.1111111111111111	0.	0.	0.1111111111111111
67	0.25120890031192966	0.6855366117028813	0.2222222222222222	0.6666666666666666	0.1111111111111111	0.	0.	0.1111111111111111
68	0.5098923803519677	0.1790562570547648	0.4444444444444444	0.1111111111111111	0.1111111111111111	0.	0.	0.1111111111111111
69	0.8735189136232459	0.8859905049231062	0.7777777777777778	0.7777777777777778	0.1111111111111111	0.	0.	0.1111111111111111
70	0.11893987104022272	0.2869311910174511	0.1111111111111111	0.2222222222222222	0.1111111111111111	0.	0.	0.1111111111111111
71	0.33624013364972033	0.654189116294604	0.3333333333333333	0.5555555555555556	0.1111111111111111	0.	0.	0.1111111111111111
72	0.7823754385896715	0.2191913508563388	0.7777777777777778	0.1111111111111111	0.1111111111111111	0.	0.	0.1111111111111111
73	0.1523014175604602	0.5323162967769628	0.1111111111111111	0.4444444444444444	0.1111111111111111	0.	0.	0.1111111111111111
74	0.38511838403741905	0.710104941472692	0.3333333333333333	0.6666666666666666	0.1111111111111111	0.	0.	0.1111111111111111
75	0.6762470479458819	0.5831883360545068	0.6666666666666666	0.5555555555555556	0.1111111111111111	0.	0.	0.1111111111111111
76	0.02272381538051971	0.7903071650227909	0.	0.7777777777777778	0.1111111111111111	0.	0.	0.1111111111111111
77	0.5643178042312229	0.3161620981451672	0.5555555555555556	0.2222222222222222	0.1111111111111111	0.	0.	0.1111111111111111
78	0.953862352385808	0.9792189970279727	0.8888888888888888	0.8888888888888888	0.1111111111111111	0.	0.	0.1111111111111111
79	0.2656727266344105	0.004330276915220145	0.2222222222222222	0.	0.1111111111111111	0.	0.	0.1111111111111111
80	0.540409487738786	0.4057935158234064	0.4444444444444444	0.3333333333333333	0.1111111111111111	0.	0.	0.1111111111111111
81	0.9865864820931898	0.9146045852692801	0.8888888888888888	0.8888888888888888	0.1111111111111111	0.	0.	0.1111111111111111
82	0.3047877023010693	0.049934640051178786	0.2222222222222222	0.	0.1111111111111111	0.	0.	0.1111111111111111
83	0.46111807043156494	0.4149490606832619	0.4444444444444444	0.3333333333333333	0.1111111111111111	0.	0.	0.1111111111111111
84	0.842852002595041	0.12322724797001292	0.7777777777777778	0.1111111111111111	0.1111111111111111	0.	0.	0.1111111111111111
85	0.20150416205788232	0.4615220354715588	0.1111111111111111	0.4444444444444444	0.1111111111111111	0.	0.	0.1111111111111111
86	0.4235785621205663	0.7542447081746023	0.3333333333333333	0.6666666666666666	0.1111111111111111	0.	0.	0.1111111111111111
87	0.7275328633088032	0.6188852882274898	0.6666666666666666	0.5555555555555556	0.1111111111111111	0.	0.	0.1111111111111111
88	0.04184081153918183	0.8292041690822054	0.	0.7777777777777778	0.1111111111111111	0.	0.	0.1111111111111111
89	0.6007182142948907	0.2538514330700082	0.5555555555555556	0.2222222222222222	0.1111111111111111	0.	0.	0.1111111111111111
90	0.7550105539203943	0.6879930976839311	0.6666666666666666	0.6666666666666666	0.1111111111111111	0.	0.	0.1111111111111111
91	0.09641179302729135	0.18208373503618872	0.	0.1111111111111111	0.1111111111111111	0.	0.	0.1111111111111111
92	0.6474004992544419	0.48662189366035313	0.5555555555555556	0.4444444444444444	0.1111111111111111	0.	0.	0.1111111111111111
93	0.9026690368631142	0.2897723709875	0.8888888888888888	0.2222222222222222	0.1111111111111111	0.	0.	0.1111111111111111
94	0.2588441013849769	0.6457228965330569	0.2222222222222222	0.5555555555555556	0.1111111111111111	0.	0.	0.1111111111111111
95	0.5116957929742671	0.8772465894715926	0.4444444444444444	0.7777777777777778	0.1111111111111111	0.	0.	0.1111111111111111
96	0.8662015687387492	0.3525153750967466	0.7777777777777778	0.3333333333333333	0.1111111111111111	0.	0.	0.1111111111111111
97	0.12137105634596422	0.9378963769776256	0.1111111111111111	0.8888888888888888	0.1111111111111111	0.	0.	0.1111111111111111
98	0.3383079282624105	0.08793454218507615	0.3333333333333333	0.	0.1111111111111111	0.	0.	0.1111111111111111
99	0.7872717946692455	0.7960268212178456	0.7777777777777778	0.7777777777777778	0.1111111111111111	0.	0.	0.1111111111111111
100	0.1577831711769207	0.31966665896530155	0.1111111111111111	0.2222222222222222	0.1111111111111111	0.	0.	0.1111111111111111
101	0.3902683775371176	0.5860108945692166	0.3333333333333333	0.5555555555555556	0.1111111111111111	0.	0.	0.1111111111111111
102	0.6685412181870088	0.010977527313998101	0.6666666666666666	0.	0.1111111111111111	0.	0.	0.1111111111111111
103	0.015211939397454011	0.39729362807826785	0.	0.3333333333333333	0.1111111111111111	0.	0.	0.1111111111111111
104	0.5577751550804876	0.9817226109587612	0.5555555555555556	0.8888888888888888	0.1111111111111111	0.	0.	0.1111111111111111
105	0.9576425585827325	0.5360092145255644	0.8888888888888888	0.4444444444444444	0.1111111111111111	0.	0.	0.1111111111111111
106	0.2693035025999017	0.7120543780360913	0.2222222222222222	0.6666666666666666	0.1111111111111111	0.	0.	0.1111111111111111
107	0.533314055055049	0.21304023666819202	0.4444444444444444	0.1111111111111111	0.1111111111111111	0.	0.	0.1111111111111111
108	0.9284841153561191	0.7202689547652362	0.8888888888888888	0.6666666666666666	0.1111111111111111	0.	0.	0.1111111111111111
109	0.27774038989111566	0.1897040694028274	0.2222222222222222	0.1111111111111111	0.1111111111111111	0.	0.	0.1111111111111111
110	0.5514339218818823	0.5453434609993829	0.4444444444444444	0.4444444444444444	0.1111111111111111	0.	0.	0.1111111111111111
111	0.7954124955946769	0.32932073278482016	0.7777777777777778	0.2222222222222222	0.1111111111111111	0.	0.	0.1111111111111111
112	0.16214430431599264	0.556345108531418	0.1111111111111111	0.5555555555555556	0.1111111111111111	0.	0.	0.1111111111111111
113	0.4034089998786822	0.805440677144982	0.3333333333333333	0.7777777777777778	0.1111111111111111	0.	0.	0.1111111111111111
114	0.6866190643486249	0.3817125221789703	0.6666666666666666	0.3333333333333333	0.1111111111111111	0.	0.	0.1111111111111111
115	0.03196673558824952	0.9974406206482281	0.	0.8888888888888888	0.1111111111111111	0.	0.	0.1111111111111111
116	0.578546361633789	0.022948794877323424	0.5555555555555556	0.	0.1111111111111111	0.	0.	0.1111111111111111
117	0.732087707593252	0.8438886333654905	0.6666666666666666	0.7777777777777778	0.1111111111111111	0.	0.	0.1111111111111111
118	0.058999261308213015	0.23260287695660142	0.	0.2222222222222222	0.1111111111111111	0.	0.	0.1111111111111111
119	0.6120264374212452	0.5967836400791562	0.5555555555555556	0.5555555555555556	0.1111111111111111	0.	0.	0.1111111111111111
120	0.9976921724791209	0.06414589067676628	0.8888888888888888	0.	0.1111111111111111	0.	0.	0.1111111111111111
121	0.31126453837774876	0.43080757404134096	0.2222222222222222	0.3333333333333333	0.1111111111111111	0.	0.	0.1111111111111111
122	0.47531614502023234	0.8970556218224863	0.4444444444444444	0.8888888888888888	0.1111111111111111	0.	0.	0.1111111111111111
123	0.8240221612715652	0.4715016324291512	0.7777777777777778	0.4444444444444444	0.1111111111111111	0.	0.	0.1111111111111111
124	0.21187310514183982	0.7658312826093202	0.1111111111111111	0.6666666666666666	0.1111111111111111	0.	0.	0.1111111111111111
125	0.44014650878897293	0.12476359590092131	0.3333333333333333	0.1111111111111111	0.1111111111111111	0.	0.	0.1111111111111111
126	0.8853535621860206	0.9448496049985626	0.7777777777777778	0.8888888888888888	0.1111111111111111	0.	0.	0.1111111111111111
127	0.1276147306017502	0.10082520011824501	0.1111111111111111	0.	0.1111111111111111	0.	0.	0.1111111111111111
128	0.35159095401723417	0.36580728955716124	0.3333333333333333	0.3333333333333333	0.1111111111111111	0.	0.	0.1111111111111111
129	0.7715293481376339	0.157461589492754	0.6666666666666666	0.1111111111111111	0.1111111111111111	0.	0.	0.1111111111111111
130	0.10022083524859732	0.49842354448459064	0.	0.4444444444444444	0.1111111111111111	0.	0.	0.1111111111111111
131	0.6551709470034424	0.7004264652266924	0.5555555555555556	0.6666666666666666	0.1111111111111111	0.	0.	0.1111111111111111
132	0.9210555158153584	0.6585252266648535	0.8888888888888888	0.5555555555555556	0.1111111111111111	0.	0.	0.1111111111111111
133	0.23153028697973693	0.8617252988565266	0.2222222222222222	0.7777777777777778	0.1111111111111111	0.	0.	0.1111111111111111
134	0.48433817689320335	0.26682208419114706	0.4444444444444444	0.2222222222222222	0.1111111111111111	0.	0.	0.1111111111111111
135	0.8966870369453624	0.8680014847295975	0.8888888888888888	0.7777777777777778	0.1111111111111111	0.	0.	0.1111111111111111
136	0.24667040949056954	0.2755594443190811	0.2222222222222222	0.2222222222222222	0.1111111111111111	0.	0.	0.1111111111111111
137	0.49970617325817274	0.6313798657492617	0.4444444444444444	0.5555555555555556	0.1111111111111111	0.	0.	0.1111111111111111
138	0.8566918970221697	0.08306565152606923	0.7777777777777778	0.	0.1111111111111111	0.	0.	0.1111111111111111
139	0.14459663661894423	0.33487368208516893	0.1111111111111111	0.3333333333333333	0.1111111111111111	0.	0.	0.1111111111111111
140	0.36571538252674435	0.9592206191586666	0.3333333333333333	0.8888888888888888	0.1111111111111111	0.	0.	0.1111111111111111
141	0.7464388088502293	0.5108636876111802	0.6666666666666666	0.4444444444444444	0.1111111111111111	0.	0.	0.1111111111111111
142	0.07634529451366559	0.6685812909256503	0.	0.6666666666666666	0.1111111111111111	0.	0.	0.1111111111111111
143	0.634558492164139	0.1718006521505027	0.5555555555555556	0.1111111111111111	0.1111111111111111	0.	0.	0.1111111111111111
144	0.701220978360113	0.9637547176809227	0.6666666666666666	0.8888888888888888	0.1111111111111111	0.	0.	0.1111111111111111
145	0.000995760448797534	0.03292724063095865	0.	0.	0.1111111111111111	0.	0.	0.1111111111111111
146	0.5839717750876792	0.3909408294958126	0.5555555555555556	0.3333333333333333	0.1111111111111111	0.	0.	0.1111111111111111
147	0.9470293451619696	0.207136869659295	0.8888888888888888	0.1111111111111111	0.1111111111111111	0.	0.	0.1111111111111111
148	0.28845712907042464	0.522555439756311	0.2222222222222222	0.4444444444444444	0.1111111111111111	0.	0.	0.1111111111111111
149	0.5265618196735761	0.7357081167003878	0.4444444444444444	0.6666666666666666	0.1111111111111111	0.	0.	0.1111111111111111
150	0.8088382353641257	0.5770880451980088	0.7777777777777778	0.5555555555555556	0.1111111111111111	0.	0.	0.1111111111111111
151	0.17502762224844542	0.7785078518825232	0.1111111111111111	0.7777777777777778	0.1111111111111111	0.	0.	0.1111111111111111
152	0.37732458956242765	0.3083194566580258	0.3333333333333333	0.2222222222222222	0.1111111111111111	0.	0.	0.1111111111111111
153	0.8354918050466522	0.7423267427311173	0.7777777777777778	0.6666666666666666	0.1111111111111111	0.	0.	0.1111111111111111
154	0.1936686041747609	0.13919639736279754	0.1111111111111111	0.1111111111111111	0.1111111111111111	0.	0.	0.1111111111111111
155	0.41335750142355887	0.45248294117282317	0.3333333333333333	0.4444444444444444	0.1111111111111111	0.	0.	0.1111111111111111
156	0.7053511815340946	0.23640090616546272	0.6666666666666666	0.2222222222222222	0.1111111111111111	0.	0.	0.1111111111111111
157	0.0625626058030538	0.6096407048828025	0.	0.5555555555555556	0.1111111111111111	0.	0.	0.1111111111111111
158	0.6189328850906489	0.817566992436479	0.5555555555555556	0.7777777777777778	0.1111111111111111	0.	0.	0.1111111111111111
159	0.97290140222811	0.4390267986058941	0.8888888888888888	0.3333333333333333	0.1111111111111111	0.	0.	0.1111111111111111
160	0.3276103422604478	0.910135592579187	0.2222222222222222	0.8888888888888888	0.1111111111111111	0.	0.	0.1111111111111111
161	0.4456618727427879	0.04584363201640927	0.4444444444444444	0.	0.1111111111111111	0.	0.	0.1111111111111111
162	0.8996399525305782	0.34041643918665687	0.8888888888888888	0.3333333333333333	0.1111111111111111	0.	0.	0.1111111111111111
163	0.23562505836735273	0.9523812639656237	0.2222222222222222	0.8888888888888888	0.1111111111111111	0.	0.	0.1111111111111111
164	0.5046844377574121	0.07474337011639053	0.4444444444444444	0.	0.1111111111111111	0.	0.	0.1111111111111111
165	0.8602065665831802	0.672995300290722	0.7777777777777778	0.6666666666666666	0.1111111111111111	0.	0.	0.1111111111111111
166	0.13807644885124631	0.1639034635568797	0.1111111111111111	0.1111111111111111	0.1111111111111111	0.	0.	0.1111111111111111
167	0.3671151493143325	0.5182862170892224	0.3333333333333333	0.4444444444444444	0.1111111111111111	0.	0.	0.1111111111111111
168	0.751042487240954	0.27614435573471524	0.6666666666666666	0.2222222222222222	0.1111111111111111	0.	0.	0.1111111111111111
169	0.08053258467012399	0.6368726461444325	0.	0.5555555555555556	0.1111111111111111	0.	0.	0.1111111111111111
170	0.6379008270090055	0.8685847071965264	0.5555555555555556	0.7777777777777778	0.1111111111111111	0.	0.	0.1111111111111111
171	0.6915284347114986	0.5236005298969444	0.6666666666666666	0.4444444444444444	0.1111111111111111	0.	0.	0.1111111111111111
172	0.006639192831469823	0.7398735124718715	0.	0.6666666666666666	0.1111111111111111	0.	0.	0.1111111111111111
173	0.5861532265699728	0.1994540657003473	0.5555555555555556	0.1111111111111111	0.1111111111111111	0.	0.	0.1111111111111111
174	0.9385326856061039	0.7824853002719396	0.8888888888888888	0.7777777777777778	0.1111111111111111	0.	0.	0.1111111111111111
175	0.29323284620258344	0.2995210379800021	0.2222222222222222	0.2222222222222222	0.1111111111111111	0.	0.	0.1111111111111111
176	0.5308290204204112	0.5708414232406106	0.4444444444444444	0.5555555555555556	0.1111111111111111	0.	0.	0.1111111111111111
177	0.8108408518717588	0.026526915737455144	0.7777777777777778	0.	0.1111111111111111	0.	0.	0.1111111111111111
178	0.17700490280471462	0.39479817238060433	0.1111111111111111	0.3333333333333333	0.1111111111111111	0.	0.	0.1111111111111111
179	0.3790407937528227	0.967117682995508	0.3333333333333333	0.8888888888888888	0.1111111111111111	0.	0.	0.1111111111111111
180	0.8305793587838183	0.6164655065519781	0.7777777777777778	0.5555555555555556	0.1111111111111111	0.	0.	0.1111111111111111
181	0.1853981217808024	0.8222280795961379	0.1111111111111111	0.7777777777777778	0.1111111111111111	0.	0.	0.1111111111111111
182	0.4188230409603694	0.2416075031075602	0.3333333333333333	0.2222222222222222	0.1111111111111111	0.	0.	0.1111111111111111
183	0.7116452282763325	0.9050772436904682	0.6666666666666666	0.8888888888888888	0.1111111111111111	0.	0.	0.1111111111111111
184	0.06845361070548164	0.03777627603307613	0.	0.	0.1111111111111111	0.	0.	0.1111111111111111
185	0.6219947572261724	0.44143504845282805	0.5555555555555556	0.3333333333333333	0.1111111111111111	0.	0.	0.1111111111111111
186	0.9647318007489274	0.1422017718840884	0.8888888888888888	0.1111111111111111	0.1111111111111111	0.	0.	0.1111111111111111
187	0.3293367171399136	0.45424920208595376	0.2222222222222222	0.4444444444444444	0.1111111111111111	0.	0.	0.1111111111111111
188	0.45119616703252546	0.7470217620145881	0.4444444444444444	0.6666666666666666	0.1111111111111111	0.	0.	0.1111111111111111
189	0.9754688985142103	0.4669832902582153	0.8888888888888888	0.4444444444444444	0.1111111111111111	0.	0.	0.1111111111111111
190	0.2969232008446168	0.7581936664170593	0.2222222222222222	0.6666666666666666	0.1111111111111111	0.	0.	0.1111111111111111
191	0.46884309380618927	0.1141941772728494	0.4444444444444444	0.1111111111111111	0.1111111111111111	0.	0.	0.1111111111111111
192	0.8436572172791478	0.8345690101072584	0.7777777777777778	0.7777777777777778	0.1111111111111111	0.	0.	0.1111111111111111
193	0.20217733760591072	0.2556636707289204	0.1111111111111111	0.2222222222222222	0.1111111111111111	0.	0.	0.1111111111111111
194	0.4261293986441693	0.6224453950687502	0.3333333333333333	0.5555555555555556	0.1111111111111111	0.	0.	0.1111111111111111
195	0.7196225399770566	0.05411859705058949	0.6666666666666666	0.	0.1111111111111111	0.	0.	0.1111111111111111
196	0.04865978233450288	0.41873625067878123	0.	0.3333333333333333	0.1111111111111111	0.	0.	0.1111111111111111
197	0.6022263869821645	0.9193597123701254	0.5555555555555556	0.8888888888888888	0.1111111111111111	0.	0.	0.1111111111111111
198	0.7575208212594043	0.6475932596671038	0.6666666666666666	0.5555555555555556	0.1111111111111111	0.	0.	0.1111111111111111
199	0.0892616858991162	0.883458561738587	0.	0.7777777777777778	0.1111111111111111	0.	0.	0.1111111111111111
200	0.6525060776191077	0.29400138583446644	0.5555555555555556	0.2222222222222222	0.1111111111111111	0.	0.	0.1111111111111111
201	0.909379366011452	0.9295870608089256	0.8888888888888888	0.8888888888888888	0.1111111111111111	0.	0.	0.1111111111111111
202	0.24851949944237461	0.09222865081872324	0.2222222222222222	0.	0.1111111111111111	0.	0.	0.1111111111111111
203	0.5155648724608367	0.3539992976468521	0.4444444444444444	0.3333333333333333	0.1111111111111111	0.	0.	0.1111111111111111
204	0.8714949671475257	0.17316470580367274	0.7777777777777778	0.1111111111111111	0.1111111111111111	0.	0.	0.1111111111111111
205	0.11512867697953201	0.4918251195881727	0.1111111111111111	0.4444444444444444	0.1111111111111111	0.	0.	0.1111111111111111
206	0.34561360623684867	0.6827118316570673	0.3333333333333333	0.6666666666666666	0.1111111111111111	0.	0.	0.1111111111111111
207	0.7812766410847553	0.40316069172411106	0.7777777777777778	0.3333333333333333	0.1111111111111111	0.	0.	0.1111111111111111
208	0.14915301412121934	0.9838553212570714	0.1111111111111111	0.8888888888888888	0.1111111111111111	0.	0.	0.1111111111111111
209	0.39384541258305356	0.003994648477836872	0.3333333333333333	0.	0.1111111111111111	0.	0.	0.1111111111111111
210	0.6746523732082051	0.7044757064117657	0.6666666666666666	0.6666666666666666	0.1111111111111111	0.	0.	0.1111111111111111
211	0.017994439800179663	0.2166898164920407	0.	0.1111111111111111	0.1111111111111111	0.	0.	0.1111111111111111
212	0.5599102460823474	0.5398924044343285	0.5555555555555556	0.4444444444444444	0.1111111111111111	0.	0.	0.1111111111111111
213	0.958989813950358	0.30930223895997067	0.8888888888888888	0.2222222222222222	0.1111111111111111	0.	0.	0.1111111111111111
214	0.2606797330914181	0.5896594204133588	0.2222222222222222	0.5555555555555556	0.1111111111111111	0.	0.	0.1111111111111111