0	0.9033690841615075	0.4611137331975232	0.8888888888888888	0.4444444444444444	0.1111111111111111	0.	0.	0.1111111111111111
1	0.1988710497274018	0.21020286479135253	0.1111111111111111	0.1111111111111111	0.1111111111111111	0.	0.	0.1111111111111111
2	0.6654241183752504	0.7847603993568515	0.5555555555555556	0.7777777777777778	0.1111111111111111	0.	0.	0.1111111111111111
3	0.26420968664876165	0.4383799691089647	0.2222222222222222	0.3333333333333333	0.1111111111111111	0.	0.	0.1111111111111111
4	0.3377948208275239	0.0963597918195459	0.3333333333333333	0.	0.1111111111111111	0.	0.	0.1111111111111111
5	0.7137567557335187	0.7739986281417348	0.6666666666666666	0.6666666666666666	0.1111111111111111	0.	0.	0.1111111111111111
6	0.5147729843821794	0.5860318889845808	0.4444444444444444	0.5555555555555556	0.1111111111111111	0.	0.	0.1111111111111111
7	0.8324693491709815	0.2838822436845014	0.7777777777777778	0.2222222222222222	0.1111111111111111	0.	0.	0.1111111111111111
8	0.06937528283384103	0.9145507230345099	0.	0.8888888888888888	0.1111111111111111	0.	0.	0.1111111111111111
9	0.38921221501701914	0.7012167254444478	0.3333333333333333	0.6666666666666666	0.1111111111111111	0.	0.	0.1111111111111111
10	0.751373211446233	0.36405409455082627	0.6666666666666666	0.3333333333333333	0.1111111111111111	0.	0.	0.1111111111111111
11	0.3141784945710499	0.025368681520610035	0.2222222222222222	0.	0.1111111111111111	0.	0.	0.1111111111111111
12	0.8674147011018478	0.9466060324961286	0.7777777777777778	0.8888888888888888	0.1111111111111111	0.	0.	0.1111111111111111
13	0.08482115754423442	0.6086920999162748	0.	0.5555555555555556	0.1111111111111111	0.	0.	0.1111111111111111
14	0.5381649506237997	0.296484701406693	0.4444444444444444	0.2222222222222222	0.1111111111111111	0.	0.	0.1111111111111111
15	0.12016195921945681	0.8184313848546441	0.1111111111111111	0.7777777777777778	0.1111111111111111	0.	0.	0.1111111111111111
16	0.5689092814087073	0.51594501153672	0.5555555555555556	0.4444444444444444	0.1111111111111111	0.	0.	0.1111111111111111
17	0.939470454800856	0.11695463014089581	0.8888888888888888	0.1111111111111111	0.1111111111111111	0.	0.	0.1111111111111111
18	0.0023844247432148595	0.2589298910311375	0.	0.2222222222222222	0.1111111111111111	0.	0.	0.1111111111111111
19	0.4446132334868158	0.9750836151569671	0.4444444444444444	0.8888888888888888	0.1111111111111111	0.	0.	0.1111111111111111
20	0.8097392985325564	0.6319531463912844	0.7777777777777778	0.5555555555555556	0.1111111111111111	0.	0.	0.1111111111111111
21	0.6055148854040088	0.16360057990290414	0.5555555555555556	0.1111111111111111	0.1111111111111111	0.	0.	0.1111111111111111
22	0.9997454170095101	0.8622108806434345	0.8888888888888888	0.7777777777777778	0.1111111111111111	0.	0.	0.1111111111111111
23	0.18322644520744494	0.5314300684804515	0.1111111111111111	0.4444444444444444	0.1111111111111111	0.	0.	0.1111111111111111
24	0.6858093197027584	0.0391836469616006	0.6666666666666666	0.	0.1111111111111111	0.	0.	0.1111111111111111
25	0.22447089351883331	0.7051722691241902	0.2222222222222222	0.6666666666666666	0.1111111111111111	0.	0.	0.1111111111111111
26	0.43794765502623356	0.3801294704713807	0.3333333333333333	0.3333333333333333	0.1111111111111111	0.	0.	0.1111111111111111
27	0.41812746683789015	0.8727509556160826	0.3333333333333333	0.7777777777777778	0.1111111111111111	0.	0.	0.1111111111111111
28	0.6979035432480701	0.5487032626540651	0.6666666666666666	0.4444444444444444	0.1111111111111111	0.	0.	0.1111111111111111
29	0.24207872323792703	0.18110844588466432	0.2222222222222222	0.1111111111111111	0.1111111111111111	0.	0.	0.1111111111111111
30	0.7854961890429774	0.7160856292932579	0.7777777777777778	0.6666666666666666	0.1111111111111111	0.	0.	0.1111111111111111
31	0.01860270912689563	0.3862227327889208	0.	0.3333333333333333	0.1111111111111111	0.	0.	0.1111111111111111
32	0.4609189715140062	0.050284126816018765	0.4444444444444444	0.	0.1111111111111111	0.	0.	0.1111111111111111
33	0.15086528374084002	0.9853811749916683	0.1111111111111111	0.8888888888888888	0.1111111111111111	0.	0.	0.1111111111111111
34	0.6209403077457442	0.642828855824057	0.5555555555555556	0.5555555555555556	0.1111111111111111	0.	0.	0.1111111111111111
35	0.9649156690144319	0.23337918248304101	0.8888888888888888	0.2222222222222222	0.1111111111111111	0.	0.	0.1111111111111111
36	0.04620295563838046	0.1014361641914435	0.	0.	0.1111111111111111	0.	0.	0.1111111111111111
37	0.4835692690137168	0.745010421136159	0.4444444444444444	0.6666666666666666	0.1111111111111111	0.	0.	0.1111111111111111
38	0.8409975076632219	0.41844702057906225	0.7777777777777778	0.3333333333333333	0.1111111111111111	0.	0.	0.1111111111111111
39	0.6402371188650962	0.2961553288766133	0.5555555555555556	0.2222222222222222	0.1111111111111111	0.	0.	0.1111111111111111
40	0.9185862599022223	0.8968052014065439	0.8888888888888888	0.8888888888888888	0.1111111111111111	0.	0.	0.1111111111111111
41	0.21253496912153932	0.557317337270031	0.1111111111111111	0.5555555555555556	0.1111111111111111	0.	0.	0.1111111111111111
42	0.725671359627033	0.1897453045305166	0.6666666666666666	0.1111111111111111	0.1111111111111111	0.	0.	0.1111111111111111
43	0.2830173909568319	0.7954110234646539	0.2222222222222222	0.7777777777777778	0.1111111111111111	0.	0.	0.1111111111111111
44	0.3529639755320221	0.48025421116365724	0.3333333333333333	0.4444444444444444	0.1111111111111111	0.	0.	0.1111111111111111
45	0.9562587606631892	0.6215732109442806	0.8888888888888888	0.5555555555555556	0.1111111111111111	0.	0.	0.1111111111111111
46	0.1269743858762892	0.31987650761547615	0.1111111111111111	0.2222222222222222	0.1111111111111111	0.	0.	0.1111111111111111
47	0.5864731046787771	0.9585077072851114	0.5555555555555556	0.8888888888888888	0.1111111111111111	0.	0.	0.1111111111111111
48	0.33138128462104477	0.4878870539033365	0.2222222222222222	0.4444444444444444	0.1111111111111111	0.	0.	0.1111111111111111
49	0.39862402407254544	0.13197153855226282	0.3333333333333333	0.1111111111111111	0.1111111111111111	0.	0.	0.1111111111111111
50	0.7618498093080118	0.8287438630192495	0.6666666666666666	0.7777777777777778	0.1111111111111111	0.	0.	0.1111111111111111
51	0.5541479858765721	0.33516492550122556	0.4444444444444444	0.3333333333333333	0.1111111111111111	0.	0.	0.1111111111111111
52	0.8878525721613724	0.004629882477210268	0.7777777777777778	0.	0.1111111111111111	0.	0.	0.1111111111111111
53	0.09434716895763698	0.6773607345273885	0.	0.6666666666666666	0.1111111111111111	0.	0.	0.1111111111111111
54	0.09981571298190513	0.14125902102198834	0.	0.1111111111111111	0.1111111111111111	0.	0.	0.1111111111111111
55	0.5293744260386807	0.8448624684552156	0.4444444444444444	0.7777777777777778	0.1111111111111111	0.	0.	0.1111111111111111
56	0.8634942570973146	0.5013554450050438	0.7777777777777778	0.4444444444444444	0.1111111111111111	0.	0.	0.1111111111111111
57	0.5597917804841068	0.015500866639330821	0.5555555555555556	0.	0.1111111111111111	0.	0.	0.1111111111111111
58	0.9282166609073345	0.6909902580466432	0.8888888888888888	0.6666666666666666	0.1111111111111111	0.	0.	0.1111111111111111
59	0.1434331161561256	0.3466542412697918	0.1111111111111111	0.3333333333333333	0.1111111111111111	0.	0.	0.1111111111111111
60	0.7704949363171136	0.32768320022090175	0.6666666666666666	0.2222222222222222	0.1111111111111111	0.	0.	0.1111111111111111
61	0.30390486222666807	0.9348788597497228	0.2222222222222222	0.8888888888888888	0.1111111111111111	0.	0.	0.1111111111111111
62	0.38262739291175357	0.5932030972166783	0.3333333333333333	0.5555555555555556	0.1111111111111111	0.	0.	0.1111111111111111
63	0.9854979826153009	0.4051711309121462	0.8888888888888888	0.3333333333333333	0.1111111111111111	0.	0.	0.1111111111111111
64	0.16747797765543582	0.07086195605588291	0.1111111111111111	0.	0.1111111111111111	0.	0.	0.1111111111111111
65	0.6018319869155571	0.7377507267906355	0.5555555555555556	0.6666666666666666	0.1111111111111111	0.	0.	0.1111111111111111
66	0.2583417643321044	0.6595991373428196	0.2222222222222222	0.5555555555555556	0.1111111111111111	0.	0.	0.1111111111111111
67	0.43182739620154686	0.245761102049854	0.3333333333333333	0.2222222222222222	0.1111111111111111	0.	0.	0.1111111111111111
68	0.6695319634131862	0.9917603858753755	0.6666666666666666	0.8888888888888888	0.1111111111111111	0.	0.	0.1111111111111111
69	0.4709676329655005	0.5196586363298922	0.4444444444444444	0.4444444444444444	0.1111111111111111	0.	0.	0.1111111111111111
70	0.7920255124486547	0.1493901483701171	0.7777777777777778	0.1111111111111111	0.1111111111111111	0.	0.	0.1111111111111111
71	0.036368474048361445	0.8825764908542736	0.	0.7777777777777778	0.1111111111111111	0.	0.	0.1111111111111111
72	0.36965275559634464	0.9131996475281927	0.3333333333333333	0.8888888888888888	0.1111111111111111	0.	0.	0.1111111111111111
73	0.7386937306078651	0.5760353861924943	0.6666666666666666	0.5555555555555556	0.1111111111111111	0.	0.	0.1111111111111111
74	0.2853390312044132	0.26342198953757456	0.2222222222222222	0.2222222222222222	0.1111111111111111	0.	0.	0.1111111111111111
75	0.8214732640706224	0.81017953768229	0.7777777777777778	0.7777777777777778	0.1111111111111111	0.	0.	0.1111111111111111
76	0.05462389212977325	0.4533122666106593	0.	0.4444444444444444	0.1111111111111111	0.	0.	0.1111111111111111
77	0.5046894676066895	0.19912935563233292	0.4444444444444444	0.1111111111111111	0.1111111111111111	0.	0.	0.1111111111111111
78	0.18833275146340203	0.7531426859219795	0.1111111111111111	0.6666666666666666	0.1111111111111111	0.	0.	0.1111111111111111
79	0.6453844993555139	0.42443055027307386	0.5555555555555556	0.3333333333333333	0.1111111111111111	0.	0.	0.1111111111111111
80	0.894040254713185	0.07562282627063985	0.8888888888888888	0.	0.1111111111111111	0.	0.	0.1111111111111111
81	0.7973469123019632	0.8423394681809581	0.7777777777777778	0.7777777777777778	0.1111111111111111	0.	0.	0.1111111111111111
82	0.026158361834428774	0.49482057551513065	0.	0.4444444444444444	0.1111111111111111	0.	0.	0.1111111111111111
83	0.47631793939530137	0.1373134836965218	0.4444444444444444	0.1111111111111111	0.1111111111111111	0.	0.	0.1111111111111111
84	0.17102868385810474	0.6863526174184006	0.1111111111111111	0.6666666666666666	0.1111111111111111	0.	0.	0.1111111111111111
85	0.5950025597811548	0.3567476731980482	0.5555555555555556	0.3333333333333333	0.1111111111111111	0.	0.	0.1111111111111111
86	0.9768023549213992	0.02266477702990045	0.8888888888888888	0.	0.1111111111111111	0.	0.	0.1111111111111111
87	0.42129618928509144	0.9311789659460508	0.3333333333333333	0.8888888888888888	0.1111111111111111	0.	0.	0.1111111111111111
88	0.6731216866540066	0.6048463981297938	0.6666666666666666	0.5555555555555556	0.1111111111111111	0.	0.	0.1111111111111111
89	0.2484278376235629	0.3239660899813691	0.2222222222222222	0.2222222222222222	0.1111111111111111	0.	0.	0.1111111111111111
90	0.6495142895415288	0.06902578058195231	0.5555555555555556	0.	0.1111111111111111	0.	0.	0.1111111111111111
91	0.8987721641467789	0.73619738526529	0.8888888888888888	0.6666666666666666	0.1111111111111111	0.	0.	0.1111111111111111
92	0.19194510042205504	0.400348019969245	0.1111111111111111	0.3333333333333333	0.1111111111111111	0.	0.	0.1111111111111111
93	0.7324620028894068	0.24013047573571503	0.6666666666666666	0.2222222222222222	0.1111111111111111	0.	0.	0.1111111111111111
94	0.28868169643965325	0.996112246574204	0.2222222222222222	0.8888888888888888	0.1111111111111111	0.	0.	0.1111111111111111
95	0.361147226263503	0.6553216161987758	0.3333333333333333	0.5555555555555556	0.1111111111111111	0.	0.	0.1111111111111111
96	0.06140962771847619	0.15944986327246113	0.	0.1111111111111111	0.1111111111111111	0.	0.	0.1111111111111111
97	0.4953079684263507	0.880421624611943	0.4444444444444444	0.7777777777777778	0.1111111111111111	0.	0.	0.1111111111111111
98	0.8266724220669703	0.5287577377801858	0.7777777777777778	0.4444444444444444	0.1111111111111111	0.	0.	0.1111111111111111
99	0.30730854213202613	0.5706621193525296	0.2222222222222222	0.5555555555555556	0.1111111111111111	0.	0.	0.1111111111111111
100	0.3718273738485732	0.26001363856623494	0.3333333333333333	0.2222222222222222	0.1111111111111111	0.	0.	0.1111111111111111
101	0.7766395949871063	0.9069426363422578	0.6666666666666666	0.8888888888888888	0.1111111111111111	0.	0.	0.1111111111111111
102	0.5191281610302236	0.45126293083929636	0.4444444444444444	0.4444444444444444	0.1111111111111111	0.	0.	0.1111111111111111
103	0.8551812326408306	0.20761874143763562	0.7777777777777778	0.1111111111111111	0.1111111111111111	0.	0.	0.1111111111111111
104	0.10695237735176501	0.8042794393010708	0.	0.7777777777777778	0.1111111111111111	0.	0.	0.1111111111111111
105	0.9333374492746563	0.4200681446148296	0.8888888888888888	0.3333333333333333	0.1111111111111111	0.	0.	0.1111111111111111
106	0.14702681698730022	0.08336130186788686	0.1111111111111111	0.	0.1111111111111111	0.	0.	0.1111111111111111
107	0.5640666524824228	0.7617429607171172	0.5555555555555556	0.6666666666666666	0.1111111111111111	0.	0.	0.1111111111111111
108	0.5741608191851034	0.21817128692609414	0.5555555555555556	0.1111111111111111	0.1111111111111111	0.	0.	0.1111111111111111
109	0.945562194225269	0.779371323681679	0.8888888888888888	0.7777777777777778	0.1111111111111111	0.	0.	0.1111111111111111
110	0.11379838681342092	0.4573381670924827	0.1111111111111111	0.4444444444444444	0.1111111111111111	0.	0.	0.1111111111111111
111	0.7445677806334777	0.09220446176935848	0.6666666666666666	0.	0.1111111111111111	0.	0.	0.1111111111111111
112	0.3186962955556712	0.7711451222016639	0.2222222222222222	0.6666666666666666	0.1111111111111111	0.	0.	0.1111111111111111
113	0.39383080399412407	0.4357522221804846	0.3333333333333333	0.3333333333333333	0.1111111111111111	0.	0.	0.1111111111111111
114	0.0752922087539189	0.27885226362752674	0.	0.2222222222222222	0.1111111111111111	0.	0.	0.1111111111111111
115	0.5420014427786239	0.9257441002300734	0.4444444444444444	0.8888888888888888	0.1111111111111111	0.	0.	0.1111111111111111
116	0.86952262265785	0.5802735564664471	0.7777777777777778	0.5555555555555556	0.1111111111111111	0.	0.	0.1111111111111111
117	0.22766265983418343	0.36132933502819126	0.2222222222222222	0.3333333333333333	0.1111111111111111	0.	0.	0.1111111111111111
118	0.44425489071126545	0.03326817252214729	0.3333333333333333	0.	0.1111111111111111	0.	0.	0.1111111111111111
119	0.6912274723119597	0.6968603089721118	0.6666666666666666	0.6666666666666666	0.1111111111111111	0.	0.	0.1111111111111111
120	0.4486863565614535	0.6163291912696612	0.4444444444444444	0.5555555555555556	0.1111111111111111	0.	0.	0.1111111111111111
121	0.8129467489263326	0.30785293942812963	0.7777777777777778	0.2222222222222222	0.1111111111111111	0.	0.	0.1111111111111111
122	0.007678440913158141	0.9446012564055865	0.	0.8888888888888888	0.1111111111111111	0.	0.	0.1111111111111111
123	0.989494955010842	0.5110200293683144	0.8888888888888888	0.4444444444444444	0.1111111111111111	0.	0.	0.1111111111111111
124	0.17587497633181023	0.11472195696564381	0.1111111111111111	0.1111111111111111	0.1111111111111111	0.	0.	0.1111111111111111
125	0.6091639679215143	0.8263083998464866	0.5555555555555556	0.7777777777777778	0.1111111111111111	0.	0.	0.1111111111111111
126	0.8371011047206989	0.9710086869807584	0.7777777777777778	0.8888888888888888	0.1111111111111111	0.	0.	0.1111111111111111
127	0.07077475106554489	0.6399605322198986	0.	0.5555555555555556	0.1111111111111111	0.	0.	0.1111111111111111
128	0.5066358962410651	0.253708323275248	0.4444444444444444	0.2222222222222222	0.1111111111111111	0.	0.	0.1111111111111111
129	0.20361699472912154	0.8596588051559315	0.1111111111111111	0.7777777777777778	0.1111111111111111	0.	0.	0.1111111111111111
130	0.6571084017534585	0.5421187674976066	0.5555555555555556	0.4444444444444444	0.1111111111111111	0.	0.	0.1111111111111111
131	0.9081086433367923	0.1722166230948445	0.8888888888888888	0.1111111111111111	0.1111111111111111	0.	0.	0.1111111111111111
132	0.3435516579850617	0.7135049010447837	0.3333333333333333	0.6666666666666666	0.1111111111111111	0.	0.	0.1111111111111111
133	0.7046218138108505	0.37825718866407193	0.6666666666666666	0.3333333333333333	0.1111111111111111	0.	0.	0.1111111111111111
134	0.27158326500727054	0.04676385266414413	0.2222222222222222	0.	0.1111111111111111	0.	0.	0.1111111111111111
135	0.2747051408527854	0.5471596366706356	0.2222222222222222	0.4444444444444444	0.1111111111111111	0.	0.	0.1111111111111111
136	0.3561909310033077	0.1779946732072122	0.3333333333333333	0.1111111111111111	0.1111111111111111	0.	0.	0.1111111111111111
137	0.7186193156311531	0.8713040083948684	0.6666666666666666	0.7777777777777778	0.1111111111111111	0.	0.	0.1111111111111111
138	0.4881903066653073	0.3936742032591192	0.4444444444444444	0.3333333333333333	0.1111111111111111	0.	0.	0.1111111111111111
139	0.8470142071740903	0.0577583658290549	0.7777777777777778	0.	0.1111111111111111	0.	0.	0.1111111111111111
140	0.041031953096660655	0.7256390028802359	0.	0.6666666666666666	0.1111111111111111	0.	0.	0.1111111111111111
141	0.922306202550893	0.6533951512306311	0.8888888888888888	0.5555555555555556	0.1111111111111111	0.	0.	0.1111111111111111
142	0.2149100001092955	0.22995002035974751	0.1111111111111111	0.2222222222222222	0.1111111111111111	0.	0.	0.1111111111111111
143	0.632603910458988	0.9830136070406265	0.5555555555555556	0.8888888888888888	0.1111111111111111	0.	0.	0.1111111111111111
144	0.8769790997467526	0.7437590529704794	0.7777777777777778	0.6666666666666666	0.1111111111111111	0.	0.	0.1111111111111111
145	0.09639786672889845	0.41507656211405664	0.	0.3333333333333333	0.1111111111111111	0.	0.	0.1111111111111111
146	0.5436821996956044	0.11051106884884791	0.4444444444444444	0.	0.1111111111111111	0.	0.	0.1111111111111111
147	0.1301498632579204	0.890231650431202	0.1111111111111111	0.8888888888888888	0.1111111111111111	0.	0.	0.1111111111111111
148	0.5897642109475527	0.563985567457516	0.5555555555555556	0.5555555555555556	0.1111111111111111	0.	0.	0.1111111111111111
149	0.961383505111075	0.2919594761029792	0.8888888888888888	0.2222222222222222	0.1111111111111111	0.	0.	0.1111111111111111
150	0.40123417513247045	0.7918969802687265	0.3333333333333333	0.7777777777777778	0.1111111111111111	0.	0.	0.1111111111111111
151	0.7562014322548303	0.47529198264300715	0.6666666666666666	0.4444444444444444	0.1111111111111111	0.	0.	0.1111111111111111
152	0.32111397873607733	0.1852843883363467	0.2222222222222222	0.1111111111111111	0.1111111111111111	0.	0.	0.1111111111111111
153	0.6229528178963539	0.3134050360804055	0.5555555555555556	0.2222222222222222	0.1111111111111111	0.	0.	0.1111111111111111
154	0.969103231054635	0.9508144177337681	0.8888888888888888	0.8888888888888888	0.1111111111111111	0.	0.	0.1111111111111111
155	0.1539060332626514	0.6173426189995165	0.1111111111111111	0.5555555555555556	0.1111111111111111	0.	0.	0.1111111111111111
156	0.7035825227095824	0.12944619457129433	0.6666666666666666	0.1111111111111111	0.1111111111111111	0.	0.	0.1111111111111111
157	0.2452791536966613	0.8372393171664876	0.2222222222222222	0.7777777777777778	0.1111111111111111	0.	0.	0.1111111111111111
158	0.4111480992598372	0.484268404297017	0.3333333333333333	0.4444444444444444	0.1111111111111111	0.	0.	0.1111111111111111
159	0.02366266350633476	0.003024891644282654	0.	0.	0.1111111111111111	0.	0.	0.1111111111111111
160	0.46660791258943113	0.6743087405477928	0.4444444444444444	0.6666666666666666	0.1111111111111111	0.	0.	0.1111111111111111
161	0.7896257692934426	0.3435240394147903	0.7777777777777778	0.3333333333333333	0.1111111111111111	0.	0.	0.1111111111111111
162	0.7593115921479655	0.1746877847753684	0.6666666666666666	0.1111111111111111	0.1111111111111111	0.	0.	0.1111111111111111
163	0.32819656921483403	0.8653250121041827	0.2222222222222222	0.7777777777777778	0.1111111111111111	0.	0.	0.1111111111111111
164	0.40595232862520775	0.5553790969824866	0.3333333333333333	0.4444444444444444	0.1111111111111111	0.	0.	0.1111111111111111
165	0.09016760769889656	0.055626989998112025	0.	0.	0.1111111111111111	0.	0.	0.1111111111111111
166	0.5481983452867926	0.7231595633721548	0.4444444444444444	0.6666666666666666	0.1111111111111111	0.	0.	0.1111111111111111
167	0.8819023172519924	0.3888266847273876	0.7777777777777778	0.3333333333333333	0.1111111111111111	0.	0.	0.1111111111111111
168	0.5808063049207154	0.22565871057996634	0.5555555555555556	0.2222222222222222	0.1111111111111111	0.	0.	0.1111111111111111
169	0.9513335952313733	0.9788808020424549	0.8888888888888888	0.8888888888888888	0.1111111111111111	0.	0.	0.1111111111111111
170	0.13567012025874903	0.6467516951587969	0.1111111111111111	0.5555555555555556	0.1111111111111111	0.	0.	0.1111111111111111
171	0.4587851048493893	0.40959240456347334	0.4444444444444444	0.3333333333333333	0.1111111111111111	0.	0.	0.1111111111111111
172	0.7798201099615393	0.10456881213975582	0.7777777777777778	0.	0.1111111111111111	0.	0.	0.1111111111111111
173	0.0149011496050914	0.7529492182674246	0.	0.6666666666666666	0.1111111111111111	0.	0.	0.1111111111111111
174	0.9738619175955182	0.5627894777311757	0.8888888888888888	0.5555555555555556	0.1111111111111111	0.	0.	0.1111111111111111
175	0.1590720549974148	0.2879593512326259	0.1111111111111111	0.2222222222222222	0.1111111111111111	0.	0.	0.1111111111111111
176	0.6295597279747036	0.8986769945114254	0.5555555555555556	0.8888888888888888	0.1111111111111111	0.	0.	0.1111111111111111
177	0.23741678429058682	0.4715976409463122	0.2222222222222222	0.4444444444444444	0.1111111111111111	0.	0.	0.1111111111111111
178	0.4116336449102981	0.19617790443361574	0.3333333333333333	0.1111111111111111	0.1111111111111111	0.	0.	0.1111111111111111
179	0.6942248580972702	0.7994627993633725	0.6666666666666666	0.7777777777777778	0.1111111111111111	0.	0.	0.1111111111111111
180	0.22069033025939594	0.9602279613387545	0.1111111111111111	0.8888888888888888	0.1111111111111111	0.	0.	0.1111111111111111
181	0.6368628230535668	0.6282055309676716	0.5555555555555556	0.5555555555555556	0.1111111111111111	0.	0.	0.1111111111111111
182	0.917527635801764	0.3102621176375969	0.8888888888888888	0.2222222222222222	0.1111111111111111	0.	0.	0.1111111111111111
183	0.34682620343637366	0.8333457440519277	0.3333333333333333	0.7777777777777778	0.1111111111111111	0.	0.	0.1111111111111111
184	0.7225425025640982	0.49015867528541235	0.6666666666666666	0.4444444444444444	0.1111111111111111	0.	0.	0.1111111111111111
185	0.2794450717172404	0.1250327126262717	0.2222222222222222	0.1111111111111111	0.1111111111111111	0.	0.	0.1111111111111111
186	0.8495402110754139	0.6686434241048449	0.7777777777777778	0.6666666666666666	0.1111111111111111	0.	0.	0.1111111111111111
187	0.04156337912904413	0.3383840970097308	0.	0.3333333333333333	0.1111111111111111	0.	0.	0.1111111111111111
188	0.4921151051117141	0.011349622588838702	0.4444444444444444	0.	0.1111111111111111	0.	0.	0.1111111111111111
189	0.4998370852812588	0.5041388806534357	0.4444444444444444	0.4444444444444444	0.1111111111111111	0.	0.	0.1111111111111111
190	0.815241596579576	0.14490821625079311	0.7777777777777778	0.1111111111111111	0.1111111111111111	0.	0.	0.1111111111111111
191	0.049839362006483874	0.8494668747372317	0.	0.7777777777777778	0.1111111111111111	0.	0.	0.1111111111111111
192	0.8902394240692831	0.3520663633942878	0.8888888888888888	0.3333333333333333	0.1111111111111111	0.	0.	0.1111111111111111
193	0.19406918959656091	0.02038742113782905	0.1111111111111111	0.	0.1111111111111111	0.	0.	0.1111111111111111
194	0.6514536302699263	0.6826297176038101	0.5555555555555556	0.6666666666666666	0.1111111111111111	0.	0.	0.1111111111111111
195	0.2958479470953673	0.599932436717357	0.2222222222222222	0.5555555555555556	0.1111111111111111	0.	0.	0.1111111111111111
196	0.36265191092324156	0.3314646135472373	0.3333333333333333	0.2222222222222222	0.1111111111111111	0.	0.	0.1111111111111111
197	0.7333813906780755	0.9295784457078625	0.6666666666666666	0.8888888888888888	0.1111111111111111	0.	0.	0.1111111111111111
198	0.1358739762814489	0.7289119385388694	0.1111111111111111	0.6666666666666666	0.1111111111111111	0.	0.	0.1111111111111111
199	0.5559296624259507	0.3988094135103939	0.5555555555555556	0.3333333333333333	0.1111111111111111	0.	0.	0.1111111111111111
200	0.9347991754423363	0.06542314716521527	0.8888888888888888	0.	0.1111111111111111	0.	0.	0.1111111111111111
201	0.37619793257759276	0.9924517810758671	0.3333333333333333	0.8888888888888888	0.1111111111111111	0.	0.	0.1111111111111111
202	0.7660787191872035	0.6665835141207518	0.6666666666666666	0.5555555555555556	0.1111111111111111	0.	0.	0.1111111111111111
203	0.29909495657400137	0.2364006076095784	0.2222222222222222	0.2222222222222222	0.1111111111111111	0.	0.	0.1111111111111111
204	0.8596036488921989	0.888106059873359	0.7777777777777778	0.7777777777777778	0.1111111111111111	0.	0.	0.1111111111111111
205	0.1102850938789662	0.5243982161545755	0.	0.4444444444444444	0.1111111111111111	0.	0.	0.1111111111111111
206	0.5255733975047114	0.15355527569942232	0.4444444444444444	0.1111111111111111	0.1111111111111111	0.	0.	0.1111111111111111
207	0.67852246279451	0.2704577454601272	0.6666666666666666	0.2222222222222222	0.1111111111111111	0.	0.	0.1111111111111111
208	0.2539907623040901	0.902438448473488	0.2222222222222222	0.8888888888888888	0.1111111111111111	0.	0.	0.1111111111111111
209	0.42443384901445763	0.5794820254503026	0.3333333333333333	0.5555555555555556	0.1111111111111111	0.	0.	0.1111111111111111
210	0.03208450340890463	0.2042155726048862	0.	0.1111111111111111	0.1111111111111111	0.	0.	0.1111111111111111
211	0.4780319650741721	0.8115288536877908	0.4444444444444444	0.7777777777777778	0.1111111111111111	0.	0.	0.1111111111111111
212	0.8013512548119262	0.4447768541568625	0.7777777777777778	0.4444444444444444	0.1111111111111111	0.	0.	0.1111111111111111
213	0.5998540429973663	0.0809798360113749	0.5555555555555556	0.	0.1111111111111111	0.	0.	0.1111111111111111
214	0.9821356643151967	0.757770713394906	0.8888888888888888	0.6666666666666666	0.1111111111111111	0.	0.	0.1111111111111111