0	0.38706243713059457	0.7601531557958809	0.3333333333333333	0.6666666666666666	0.1111111111111111	0.	0.	0.1111111111111111
1	0.8529108046219002	0.1388735319743677	0.7777777777777778	0.1111111111111111	0.1111111111111111	0.	0.	0.1111111111111111
2	0.022439921429486743	0.48609656608361085	0.	0.4444444444444444	0.1111111111111111	0.	0.	0.1111111111111111
3	0.938288388597159	0.7798746725550697	0.8888888888888888	0.7777777777777778	0.1111111111111111	0.	0.	0.1111111111111111
4	0.15596535732006683	0.3268620183895333	0.1111111111111111	0.2222222222222222	0.1111111111111111	0.	0.	0.1111111111111111
5	0.5405418262911403	0.5957652728411412	0.4444444444444444	0.5555555555555556	0.1111111111111111	0.	0.	0.1111111111111111
6	0.24138460575842183	0.9355911030990071	0.2222222222222222	0.8888888888888888	0.1111111111111111	0.	0.	0.1111111111111111
7	0.5920851362097166	0.038765847685114735	0.5555555555555556	0.	0.1111111111111111	0.	0.	0.1111111111111111
8	0.7529286007035799	0.4093870351119538	0.6666666666666666	0.3333333333333333	0.1111111111111111	0.	0.	0.1111111111111111
9	0.20691863907418004	0.8283912513121284	0.1111111111111111	0.7777777777777778	0.1111111111111111	0.	0.	0.1111111111111111
10	0.474730781038618	0.24393705035392002	0.4444444444444444	0.2222222222222222	0.1111111111111111	0.	0.	0.1111111111111111
11	0.971286378368767	0.6525673065267337	0.8888888888888888	0.5555555555555556	0.1111111111111111	0.	0.	0.1111111111111111
12	0.6225738437906932	0.9698189082267837	0.5555555555555556	0.8888888888888888	0.1111111111111111	0.	0.	0.1111111111111111
13	0.7024184765474979	0.1086061067875014	0.6666666666666666	0.	0.1111111111111111	0.	0.	0.1111111111111111
14	0.2626655134562765	0.3394917582688818	0.2222222222222222	0.3333333333333333	0.1111111111111111	0.	0.	0.1111111111111111
15	0.8046348756738058	0.6780763944917053	0.7777777777777778	0.6666666666666666	0.1111111111111111	0.	0.	0.1111111111111111
16	0.051468943691652135	0.14982364721207783	0.	0.1111111111111111	0.1111111111111111	0.	0.	0.1111111111111111
17	0.42841925172419054	0.5531672005435245	0.3333333333333333	0.4444444444444444	0.1111111111111111	0.	0.	0.1111111111111111
18	0.7329566385770923	0.910684867435255	0.6666666666666666	0.8888888888888888	0.1111111111111111	0.	0.	0.1111111111111111
19	0.3240042079103015	0.01230950470803142	0.2222222222222222	0.	0.1111111111111111	0.	0.	0.1111111111111111
20	0.6491917889591362	0.3730087474370344	0.5555555555555556	0.3333333333333333	0.1111111111111111	0.	0.	0.1111111111111111
21	0.08216023047419846	0.7379092539424263	0.	0.6666666666666666	0.1111111111111111	0.	0.	0.1111111111111111
22	0.35227931547695374	0.20470981509361183	0.3333333333333333	0.1111111111111111	0.1111111111111111	0.	0.	0.1111111111111111
23	0.8347948646223167	0.4695804864018607	0.7777777777777778	0.4444444444444444	0.1111111111111111	0.	0.	0.1111111111111111
24	0.5038686419774424	0.8544725797056818	0.4444444444444444	0.7777777777777778	0.1111111111111111	0.	0.	0.1111111111111111
25	0.9070692773814553	0.283936852739178	0.8888888888888888	0.2222222222222222	0.1111111111111111	0.	0.	0.1111111111111111
26	0.1333295367693714	0.5791913929122802	0.1111111111111111	0.5555555555555556	0.1111111111111111	0.	0.	0.1111111111111111
27	0.5470227036271521	0.7096991850973925	0.4444444444444444	0.6666666666666666	0.1111111111111111	0.	0.	0.1111111111111111
28	0.957597538592407	0.22041387611450433	0.8888888888888888	0.1111111111111111	0.1111111111111111	0.	0.	0.1111111111111111
29	0.1680235700354678	0.4490675754287912	0.1111111111111111	0.4444444444444444	0.1111111111111111	0.	0.	0.1111111111111111
30	0.7650001107711163	0.873476560846872	0.6666666666666666	0.7777777777777778	0.1111111111111111	0.	0.	0.1111111111111111
31	0.256842202443936	0.29552524260016627	0.2222222222222222	0.2222222222222222	0.1111111111111111	0.	0.	0.1111111111111111
32	0.5632205261778673	0.5803640593377773	0.5555555555555556	0.5555555555555556	0.1111111111111111	0.	0.	0.1111111111111111
33	0.034719567107527625	0.9139880157448256	0.	0.8888888888888888	0.1111111111111111	0.	0.	0.1111111111111111
34	0.4009832453647024	0.021322801885507232	0.3333333333333333	0.	0.1111111111111111	0.	0.	0.1111111111111111
35	0.8658681644136449	0.3845195566480912	0.7777777777777778	0.3333333333333333	0.1111111111111111	0.	0.	0.1111111111111111
36	0.28225655699209373	0.7982983187035314	0.2222222222222222	0.7777777777777778	0.1111111111111111	0.	0.	0.1111111111111111
37	0.599203816674411	0.3059375528621909	0.5555555555555556	0.2222222222222222	0.1111111111111111	0.	0.	0.1111111111111111
38	0.6678225210403539	0.6064431859892333	0.6666666666666666	0.5555555555555556	0.1111111111111111	0.	0.	0.1111111111111111
39	0.4331807070052336	0.9403926965084528	0.3333333333333333	0.8888888888888888	0.1111111111111111	0.	0.	0.1111111111111111
40	0.7897506826663128	0.05230198085883889	0.7777777777777778	0.	0.1111111111111111	0.	0.	0.1111111111111111
41	0.07224738527789464	0.42225974011405476	0.	0.3333333333333333	0.1111111111111111	0.	0.	0.1111111111111111
42	0.9798795721410595	0.7728778768848233	0.8888888888888888	0.6666666666666666	0.1111111111111111	0.	0.	0.1111111111111111
43	0.21848200014360453	0.1115033197603203	0.1111111111111111	0.1111111111111111	0.1111111111111111	0.	0.	0.1111111111111111
44	0.4455899646546573	0.4948481157897667	0.4444444444444444	0.4444444444444444	0.1111111111111111	0.	0.	0.1111111111111111
45	0.8415732481648212	0.9838290896380548	0.7777777777777778	0.8888888888888888	0.1111111111111111	0.	0.	0.1111111111111111
46	0.09757701964664722	0.08326658135694694	0.	0.	0.1111111111111111	0.	0.	0.1111111111111111
47	0.3655606660493374	0.3468092167250693	0.3333333333333333	0.3333333333333333	0.1111111111111111	0.	0.	0.1111111111111111
48	0.13833021360932723	0.6807365308618634	0.1111111111111111	0.6666666666666666	0.1111111111111111	0.	0.	0.1111111111111111
49	0.5083787063208214	0.16242097786074164	0.4444444444444444	0.1111111111111111	0.1111111111111111	0.	0.	0.1111111111111111
50	0.9159841431790323	0.5261730224770499	0.8888888888888888	0.4444444444444444	0.1111111111111111	0.	0.	0.1111111111111111
51	0.6608409715092103	0.8506184994258267	0.5555555555555556	0.7777777777777778	0.1111111111111111	0.	0.	0.1111111111111111
52	0.7136825719096132	0.2548701659744519	0.6666666666666666	0.2222222222222222	0.1111111111111111	0.	0.	0.1111111111111111
53	0.303104142228265	0.6620557549637839	0.2222222222222222	0.5555555555555556	0.1111111111111111	0.	0.	0.1111111111111111
54	0.5693713065340744	0.7032216202690303	0.5555555555555556	0.6666666666666666	0.1111111111111111	0.	0.	0.1111111111111111
55	0.7706920520320408	0.17409230516974541	0.6666666666666666	0.1111111111111111	0.1111111111111111	0.	0.	0.1111111111111111
56	0.22497744993209862	0.5348958772630462	0.2222222222222222	0.4444444444444444	0.1111111111111111	0.	0.	0.1111111111111111
57	0.8808728311733663	0.8256667688355878	0.7777777777777778	0.7777777777777778	0.1111111111111111	0.	0.	0.1111111111111111
58	0.002496595716529936	0.2248749015784071	0.	0.2222222222222222	0.1111111111111111	0.	0.	0.1111111111111111
59	0.37837035166889865	0.6332295054912975	0.3333333333333333	0.5555555555555556	0.1111111111111111	0.	0.	0.1111111111111111
60	0.17589040745510662	0.9942992156342392	0.1111111111111111	0.8888888888888888	0.1111111111111111	0.	0.	0.1111111111111111
61	0.5203110187941903	0.0973170333969267	0.4444444444444444	0.	0.1111111111111111	0.	0.	0.1111111111111111
62	0.9269821108162059	0.3687713334472957	0.8888888888888888	0.3333333333333333	0.1111111111111111	0.	0.	0.1111111111111111
63	0.03835016841352446	0.886061112099142	0.	0.7777777777777778	0.1111111111111111	0.	0.	0.1111111111111111
64	0.41945689231044603	0.26694856863907374	0.3333333333333333	0.2222222222222222	0.1111111111111111	0.	0.	0.1111111111111111
65	0.7920206615608294	0.5614687895352897	0.7777777777777778	0.5555555555555556	0.1111111111111111	0.	0.	0.1111111111111111
66	0.457828808842374	0.8995673638726939	0.4444444444444444	0.8888888888888888	0.1111111111111111	0.	0.	0.1111111111111111
67	0.9925591949440411	0.03508398252697127	0.8888888888888888	0.	0.1111111111111111	0.	0.	0.1111111111111111
68	0.18976852219776813	0.40360018319354646	0.1111111111111111	0.3333333333333333	0.1111111111111111	0.	0.	0.1111111111111111
69	0.6905979220594777	0.7258407638493963	0.6666666666666666	0.6666666666666666	0.1111111111111111	0.	0.	0.1111111111111111
70	0.2840922480655551	0.18536290595272742	0.2222222222222222	0.1111111111111111	0.1111111111111111	0.	0.	0.1111111111111111
71	0.6118569566240296	0.46540024199219193	0.5555555555555556	0.4444444444444444	0.1111111111111111	0.	0.	0.1111111111111111
72	0.8941308255554515	0.9583325633904028	0.8888888888888888	0.8888888888888888	0.1111111111111111	0.	0.	0.1111111111111111
73	0.11167326602938991	0.06175551460487333	0.1111111111111111	0.	0.1111111111111111	0.	0.	0.1111111111111111
74	0.4900963270083185	0.4362881824765856	0.4444444444444444	0.3333333333333333	0.1111111111111111	0.	0.	0.1111111111111111
75	0.3138254139505083	0.7473689412091644	0.2222222222222222	0.6666666666666666	0.1111111111111111	0.	0.	0.1111111111111111
76	0.6385115183380679	0.1322283860934366	0.5555555555555556	0.1111111111111111	0.1111111111111111	0.	0.	0.1111111111111111
77	0.7173714320514422	0.5133333410252343	0.6666666666666666	0.4444444444444444	0.1111111111111111	0.	0.	0.1111111111111111
78	0.3387318389004115	0.8032190806511528	0.3333333333333333	0.7777777777777778	0.1111111111111111	0.	0.	0.1111111111111111
79	0.81836507189307	0.30880647443850945	0.7777777777777778	0.2222222222222222	0.1111111111111111	0.	0.	0.1111111111111111
80	0.10580574895717511	0.6247961303185836	0.	0.5555555555555556	0.1111111111111111	0.	0.	0.1111111111111111
81	0.32083511033236384	0.4574613760295987	0.2222222222222222	0.4444444444444444	0.1111111111111111	0.	0.	0.1111111111111111
82	0.6310833412495813	0.719267197387006	0.5555555555555556	0.6666666666666666	0.1111111111111111	0.	0.	0.1111111111111111
83	0.7214610841090545	0.19258702998883812	0.6666666666666666	0.1111111111111111	0.1111111111111111	0.	0.	0.1111111111111111
84	0.3432925708445602	0.5672769008696732	0.3333333333333333	0.5555555555555556	0.1111111111111111	0.	0.	0.1111111111111111
85	0.81928481588386	0.8784111991901734	0.7777777777777778	0.7777777777777778	0.1111111111111111	0.	0.	0.1111111111111111
86	0.11007640675744781	0.267767430854696	0.	0.2222222222222222	0.1111111111111111	0.	0.	0.1111111111111111
87	0.89840068921428	0.39561111166047114	0.8888888888888888	0.3333333333333333	0.1111111111111111	0.	0.	0.1111111111111111
88	0.11563654118802512	0.8917396716895546	0.1111111111111111	0.8888888888888888	0.1111111111111111	0.	0.	0.1111111111111111
89	0.4828559682431596	0.026872572899295823	0.4444444444444444	0.	0.1111111111111111	0.	0.	0.1111111111111111
90	0.8870404115359011	0.6276392599359917	0.7777777777777778	0.5555555555555556	0.1111111111111111	0.	0.	0.1111111111111111
91	0.004692932833847446	0.8085210425374966	0.	0.7777777777777778	0.1111111111111111	0.	0.	0.1111111111111111
92	0.37884484558929293	0.3156550254969435	0.3333333333333333	0.2222222222222222	0.1111111111111111	0.	0.	0.1111111111111111
93	0.17703351598767234	0.44355403120320436	0.1111111111111111	0.3333333333333333	0.1111111111111111	0.	0.	0.1111111111111111
94	0.5250431734393893	0.9628267268366733	0.4444444444444444	0.8888888888888888	0.1111111111111111	0.	0.	0.1111111111111111
95	0.9328844797708501	0.069436720816625	0.8888888888888888	0.	0.1111111111111111	0.	0.	0.1111111111111111
96	0.5753276736653613	0.5172972571756095	0.5555555555555556	0.4444444444444444	0.1111111111111111	0.	0.	0.1111111111111111
97	0.77618408818848	0.7512526757458096	0.6666666666666666	0.6666666666666666	0.1111111111111111	0.	0.	0.1111111111111111
98	0.22944542133736592	0.1273819206810201	0.2222222222222222	0.1111111111111111	0.1111111111111111	0.	0.	0.1111111111111111
99	0.46115365020528554	0.35937196221269896	0.4444444444444444	0.3333333333333333	0.1111111111111111	0.	0.	0.1111111111111111
100	0.9993553507353782	0.9964611465519747	0.8888888888888888	0.8888888888888888	0.1111111111111111	0.	0.	0.1111111111111111
101	0.19548633199245521	0.08894616997570996	0.1111111111111111	0.	0.1111111111111111	0.	0.	0.1111111111111111
102	0.6803084585097066	0.5379498183088265	0.6666666666666666	0.4444444444444444	0.1111111111111111	0.	0.	0.1111111111111111
103	0.28993175422893036	0.695306126844176	0.2222222222222222	0.6666666666666666	0.1111111111111111	0.	0.	0.1111111111111111
104	0.6156918114536444	0.17745504334094903	0.5555555555555556	0.1111111111111111	0.1111111111111111	0.	0.	0.1111111111111111
105	0.04462152146699362	0.6362622051893251	0.	0.5555555555555556	0.1111111111111111	0.	0.	0.1111111111111111
106	0.41104466900475845	0.8188093247696046	0.3333333333333333	0.7777777777777778	0.1111111111111111	0.	0.	0.1111111111111111
107	0.7983354076041137	0.22747483806928961	0.7777777777777778	0.2222222222222222	0.1111111111111111	0.	0.	0.1111111111111111
108	0.08269291956144667	0.5456148482981584	0.	0.4444444444444444	0.1111111111111111	0.	0.	0.1111111111111111
109	0.35518325671206313	0.6706598972191513	0.3333333333333333	0.6666666666666666	0.1111111111111111	0.	0.	0.1111111111111111
110	0.8382490761865722	0.15443322960994282	0.7777777777777778	0.1111111111111111	0.1111111111111111	0.	0.	0.1111111111111111
111	0.4949342143165106	0.6434955732727565	0.4444444444444444	0.5555555555555556	0.1111111111111111	0.	0.	0.1111111111111111
112	0.9123250611903837	0.8318568742501381	0.8888888888888888	0.7777777777777778	0.1111111111111111	0.	0.	0.1111111111111111
113	0.1256575505139757	0.23663568036020932	0.1111111111111111	0.2222222222222222	0.1111111111111111	0.	0.	0.1111111111111111
114	0.7374802033250235	0.34386376417656805	0.6666666666666666	0.3333333333333333	0.1111111111111111	0.	0.	0.1111111111111111
115	0.3287403969317	0.9751708777935423	0.2222222222222222	0.8888888888888888	0.1111111111111111	0.	0.	0.1111111111111111
116	0.6530171622733494	0.10250473269798252	0.5555555555555556	0.	0.1111111111111111	0.	0.	0.1111111111111111
117	0.9436414276306728	0.5709725297121978	0.8888888888888888	0.5555555555555556	0.1111111111111111	0.	0.	0.1111111111111111
118	0.15896136131647223	0.857325102218157	0.1111111111111111	0.7777777777777778	0.1111111111111111	0.	0.	0.1111111111111111
119	0.5316567326240027	0.27389973774291887	0.4444444444444444	0.2222222222222222	0.1111111111111111	0.	0.	0.1111111111111111
120	0.2441991471442286	0.3760729873702334	0.2222222222222222	0.3333333333333333	0.1111111111111111	0.	0.	0.1111111111111111
121	0.5834774112837383	0.9037552520013125	0.5555555555555556	0.8888888888888888	0.1111111111111111	0.	0.	0.1111111111111111
122	0.7419098924665632	0.0027511408497895256	0.6666666666666666	0.	0.1111111111111111	0.	0.	0.1111111111111111
123	0.39432187938138025	0.47387247933257004	0.3333333333333333	0.4444444444444444	0.1111111111111111	0.	0.	0.1111111111111111
124	0.8563152218828572	0.7298018226392772	0.7777777777777778	0.6666666666666666	0.1111111111111111	0.	0.	0.1111111111111111
125	0.014381190871915911	0.20928013180015373	0.	0.1111111111111111	0.1111111111111111	0.	0.	0.1111111111111111
126	0.6295539194710308	0.4135222380215071	0.5555555555555556	0.3333333333333333	0.1111111111111111	0.	0.	0.1111111111111111
127	0.694216964864757	0.928533028618422	0.6666666666666666	0.8888888888888888	0.1111111111111111	0.	0.	0.1111111111111111
128	0.2639908159322983	0.04467917372674974	0.2222222222222222	0.	0.1111111111111111	0.	0.	0.1111111111111111
129	0.8092498948861738	0.49188704971495023	0.7777777777777778	0.4444444444444444	0.1111111111111111	0.	0.	0.1111111111111111
130	0.05369699914520181	0.7643262959521311	0.	0.6666666666666666	0.1111111111111111	0.	0.	0.1111111111111111
131	0.4220293960756423	0.14267878158951303	0.3333333333333333	0.1111111111111111	0.1111111111111111	0.	0.	0.1111111111111111
132	0.19821379056353083	0.5988950186885961	0.1111111111111111	0.5555555555555556	0.1111111111111111	0.	0.	0.1111111111111111
133	0.4777764494191908	0.7837542849555729	0.4444444444444444	0.7777777777777778	0.1111111111111111	0.	0.	0.1111111111111111
134	0.9652695609842497	0.33301646917629424	0.8888888888888888	0.2222222222222222	0.1111111111111111	0.	0.	0.1111111111111111
135	0.14262749536718491	0.49873433427695324	0.1111111111111111	0.4444444444444444	0.1111111111111111	0.	0.	0.1111111111111111
136	0.5115694547929119	0.7752932335663504	0.4444444444444444	0.6666666666666666	0.1111111111111111	0.	0.	0.1111111111111111
137	0.9203332936443294	0.11687132874723452	0.8888888888888888	0.1111111111111111	0.1111111111111111	0.	0.	0.1111111111111111
138	0.6632960197759012	0.6093038985693225	0.5555555555555556	0.5555555555555556	0.1111111111111111	0.	0.	0.1111111111111111
139	0.7075744936487687	0.8002822001841348	0.6666666666666666	0.7777777777777778	0.1111111111111111	0.	0.	0.1111111111111111
140	0.30572116093391927	0.300311440162371	0.2222222222222222	0.2222222222222222	0.1111111111111111	0.	0.	0.1111111111111111
141	0.8458061407967163	0.4248772191292134	0.7777777777777778	0.3333333333333333	0.1111111111111111	0.	0.	0.1111111111111111
142	0.09018961823673709	0.9448335105133449	0.	0.8888888888888888	0.1111111111111111	0.	0.	0.1111111111111111
143	0.3674478919982986	0.056182518180308914	0.3333333333333333	0.	0.1111111111111111	0.	0.	0.1111111111111111
144	0.7560291104445607	0.6654885376149187	0.6666666666666666	0.5555555555555556	0.1111111111111111	0.	0.	0.1111111111111111
145	0.2473926264992488	0.8399063125784588	0.2222222222222222	0.7777777777777778	0.1111111111111111	0.	0.	0.1111111111111111
146	0.564886190105449	0.2556885936923176	0.5555555555555556	0.2222222222222222	0.1111111111111111	0.	0.	0.1111111111111111
147	0.02874165146868798	0.35065877048473126	0.	0.3333333333333333	0.1111111111111111	0.	0.	0.1111111111111111
148	0.404522344024333	0.9773710729067817	0.3333333333333333	0.8888888888888888	0.1111111111111111	0.	0.	0.1111111111111111
149	0.8692353138125676	0.07770401976167383	0.7777777777777778	0.	0.1111111111111111	0.	0.	0.1111111111111111
150	0.5512799591075147	0.5286207987139611	0.4444444444444444	0.4444444444444444	0.1111111111111111	0.	0.	0.1111111111111111
151	0.9610038495752695	0.6831337960892753	0.8888888888888888	0.6666666666666666	0.1111111111111111	0.	0.	0.1111111111111111
152	0.16950532181757344	0.16869053957890534	0.1111111111111111	0.1111111111111111	0.1111111111111111	0.	0.	0.1111111111111111
153	0.4403116566541047	0.3872745744224178	0.3333333333333333	0.3333333333333333	0.1111111111111111	0.	0.	0.1111111111111111
154	0.7783234561969695	0.9181021399206382	0.7777777777777778	0.8888888888888888	0.1111111111111111	0.	0.	0.1111111111111111
155	0.06501579132193669	0.015578102272231662	0.	0.	0.1111111111111111	0.	0.	0.1111111111111111
156	0.9864353190330796	0.45326168935100736	0.8888888888888888	0.4444444444444444	0.1111111111111111	0.	0.	0.1111111111111111
157	0.21272535485339292	0.7157589859253245	0.1111111111111111	0.6666666666666666	0.1111111111111111	0.	0.	0.1111111111111111
158	0.45164586188591244	0.21031859864627173	0.4444444444444444	0.1111111111111111	0.1111111111111111	0.	0.	0.1111111111111111
159	0.272547189246187	0.58474060983388	0.2222222222222222	0.5555555555555556	0.1111111111111111	0.	0.	0.1111111111111111
160	0.6020479426252889	0.8655533281996004	0.5555555555555556	0.7777777777777778	0.1111111111111111	0.	0.	0.1111111111111111
161	0.672725041825722	0.2851439434324807	0.6666666666666666	0.2222222222222222	0.1111111111111111	0.	0.	0.1111111111111111
162	0.9754994656464853	0.1713219655418551	0.8888888888888888	0.1111111111111111	0.1111111111111111	0.	0.	0.1111111111111111
163	0.21809293966724963	0.5217587790854638	0.1111111111111111	0.4444444444444444	0.1111111111111111	0.	0.	0.1111111111111111
164	0.45397077420273807	0.6883046824781296	0.4444444444444444	0.6666666666666666	0.1111111111111111	0.	0.	0.1111111111111111
165	0.27673616318900124	0.24896570540783491	0.2222222222222222	0.2222222222222222	0.1111111111111111	0.	0.	0.1111111111111111
166	0.593151005667815	0.6569751993679405	0.5555555555555556	0.5555555555555556	0.1111111111111111	0.	0.	0.1111111111111111
167	0.6785701086999902	0.8456358692996231	0.6666666666666666	0.7777777777777778	0.1111111111111111	0.	0.	0.1111111111111111
168	0.44310322042191563	0.08020607724406303	0.3333333333333333	0.	0.1111111111111111	0.	0.	0.1111111111111111
169	0.783295089658169	0.35513001998198407	0.7777777777777778	0.3333333333333333	0.1111111111111111	0.	0.	0.1111111111111111
170	0.0692687371007887	0.9818215069501226	0.	0.8888888888888888	0.1111111111111111	0.	0.	0.1111111111111111
171	0.6577037419756429	0.2888998005472034	0.5555555555555556	0.2222222222222222	0.1111111111111111	0.	0.	0.1111111111111111
172	0.7112010863903139	0.5909396486943845	0.6666666666666666	0.5555555555555556	0.1111111111111111	0.	0.	0.1111111111111111
173	0.2978745108823262	0.8695631015013252	0.2222222222222222	0.7777777777777778	0.1111111111111111	0.	0.	0.1111111111111111
174	0.8495467061715813	0.016701289297754895	0.7777777777777778	0.	0.1111111111111111	0.	0.	0.1111111111111111
175	0.09326210072143777	0.3914634795339042	0.	0.3333333333333333	0.1111111111111111	0.	0.	0.1111111111111111
176	0.36100553181292044	0.9246100017183139	0.3333333333333333	0.8888888888888888	0.1111111111111111	0.	0.	0.1111111111111111
177	0.14445333409646632	0.21712633702929093	0.1111111111111111	0.1111111111111111	0.1111111111111111	0.	0.	0.1111111111111111
178	0.5181739901904534	0.4463150691375368	0.4444444444444444	0.4444444444444444	0.1111111111111111	0.	0.	0.1111111111111111
179	0.9239706430016235	0.7042123844238226	0.8888888888888888	0.6666666666666666	0.1111111111111111	0.	0.	0.1111111111111111
180	0.029721165142954885	0.05942781978162235	0.	0.	0.1111111111111111	0.	0.	0.1111111111111111
181	0.39858001676312993	0.42990765433334294	0.3333333333333333	0.3333333333333333	0.1111111111111111	0.	0.	0.1111111111111111
182	0.8730592941527846	0.9503583792131346	0.7777777777777778	0.8888888888888888	0.1111111111111111	0.	0.	0.1111111111111111
183	0.5541300449909866	0.1217581628730018	0.4444444444444444	0.1111111111111111	0.1111111111111111	0.	0.	0.1111111111111111
184	0.9519562993479161	0.5032659978909892	0.8888888888888888	0.4444444444444444	0.1111111111111111	0.	0.	0.1111111111111111
185	0.16285441131294082	0.7671692466080872	0.1111111111111111	0.6666666666666666	0.1111111111111111	0.	0.	0.1111111111111111
186	0.7610393565598609	0.3031685081236545	0.6666666666666666	0.2222222222222222	0.1111111111111111	0.	0.	0.1111111111111111
187	0.2550198293720082	0.6168014860291329	0.2222222222222222	0.5555555555555556	0.1111111111111111	0.	0.	0.1111111111111111
188	0.5583014617828674	0.792870903978786	0.5555555555555556	0.7777777777777778	0.1111111111111111	0.	0.	0.1111111111111111
189	0.6871526688925325	0.127754536492777	0.6666666666666666	0.1111111111111111	0.1111111111111111	0.	0.	0.1111111111111111