0	0.35600446349478787	0.30314484735473046	0.3333333333333333	0.2222222222222222	0.1111111111111111	0.	0.	0.1111111111111111
1	0.1889190352036337	0.6376515586574119	0.1111111111111111	0.5555555555555556	0.1111111111111111	0.	0.	0.1111111111111111
2	0.8973715180389784	0.8159087622922976	0.8888888888888888	0.7777777777777778	0.1111111111111111	0.	0.	0.1111111111111111
3	0.2713209264469232	0.9653380524573478	0.2222222222222222	0.8888888888888888	0.1111111111111111	0.	0.	0.1111111111111111
4	0.6953352519601341	0.036553133013743806	0.6666666666666666	0.	0.1111111111111111	0.	0.	0.1111111111111111
5	0.5041365352259417	0.42213730725015947	0.4444444444444444	0.3333333333333333	0.1111111111111111	0.	0.	0.1111111111111111
6	0.8867903989455757	0.5071023257110184	0.7777777777777778	0.4444444444444444	0.1111111111111111	0.	0.	0.1111111111111111
7	0.6513014760386958	0.724152502596905	0.5555555555555556	0.6666666666666666	0.1111111111111111	0.	0.	0.1111111111111111
8	0.022151383945003492	0.1653066168457945	0.	0.1111111111111111	0.1111111111111111	0.	0.	0.1111111111111111
9	0.5258110669171828	0.7835184077387986	0.4444444444444444	0.7777777777777778	0.1111111111111111	0.	0.	0.1111111111111111
10	0.3196336276714919	0.2698319241448275	0.2222222222222222	0.2222222222222222	0.1111111111111111	0.	0.	0.1111111111111111
11	0.7235327504839323	0.6044088382394941	0.6666666666666666	0.5555555555555556	0.1111111111111111	0.	0.	0.1111111111111111
12	0.04505664989063947	0.37753283272188193	0.	0.3333333333333333	0.1111111111111111	0.	0.	0.1111111111111111
13	0.7925531045760809	0.9270286855341475	0.7777777777777778	0.8888888888888888	0.1111111111111111	0.	0.	0.1111111111111111
14	0.5762339989888007	0.0916788967245354	0.5555555555555556	0.	0.1111111111111111	0.	0.	0.1111111111111111
15	0.9618577228457666	0.11484706736818971	0.8888888888888888	0.1111111111111111	0.1111111111111111	0.	0.	0.1111111111111111
16	0.39113475143713083	0.44891893331606086	0.3333333333333333	0.4444444444444444	0.1111111111111111	0.	0.	0.1111111111111111
17	0.128422338034889	0.6839536985183386	0.1111111111111111	0.6666666666666666	0.1111111111111111	0.	0.	0.1111111111111111
18	0.6233067365383111	0.5660971585836804	0.5555555555555556	0.5555555555555556	0.1111111111111111	0.	0.	0.1111111111111111
19	0.08380501011654035	0.8646744218355817	0.	0.7777777777777778	0.1111111111111111	0.	0.	0.1111111111111111
20	0.8376234665276053	0.2556045480599246	0.7777777777777778	0.2222222222222222	0.1111111111111111	0.	0.	0.1111111111111111
21	0.15786073031706213	0.05995295807221319	0.1111111111111111	0.	0.1111111111111111	0.	0.	0.1111111111111111
22	0.998574055798066	0.3405229100656403	0.8888888888888888	0.3333333333333333	0.1111111111111111	0.	0.	0.1111111111111111
23	0.4219876911741409	0.9226146701463348	0.3333333333333333	0.8888888888888888	0.1111111111111111	0.	0.	0.1111111111111111
24	0.743026163664428	0.7559527283201242	0.6666666666666666	0.6666666666666666	0.1111111111111111	0.	0.	0.1111111111111111
25	0.4723851892097529	0.21752297841600904	0.4444444444444444	0.1111111111111111	0.1111111111111111	0.	0.	0.1111111111111111
26	0.24379946341282263	0.5460689810514041	0.2222222222222222	0.4444444444444444	0.1111111111111111	0.	0.	0.1111111111111111
27	0.7292408129022142	0.3191762245697853	0.6666666666666666	0.2222222222222222	0.1111111111111111	0.	0.	0.1111111111111111
28	0.5428678080747213	0.6527406590861365	0.4444444444444444	0.5555555555555556	0.1111111111111111	0.	0.	0.1111111111111111
29	0.332922789739187	0.8371217205637602	0.2222222222222222	0.7777777777777778	0.1111111111111111	0.	0.	0.1111111111111111
30	0.5888613512814669	0.9780315800489324	0.5555555555555556	0.8888888888888888	0.1111111111111111	0.	0.	0.1111111111111111
31	0.05447200461993808	0.008585920882121099	0.	0.	0.1111111111111111	0.	0.	0.1111111111111111
32	0.8057041445391049	0.43352495140407166	0.7777777777777778	0.3333333333333333	0.1111111111111111	0.	0.	0.1111111111111111
33	0.144269379791802	0.4936449415990147	0.1111111111111111	0.4444444444444444	0.1111111111111111	0.	0.	0.1111111111111111
34	0.9380184785907559	0.7364940198950949	0.8888888888888888	0.6666666666666666	0.1111111111111111	0.	0.	0.1111111111111111
35	0.4046055284047372	0.18111201478900962	0.3333333333333333	0.1111111111111111	0.1111111111111111	0.	0.	0.1111111111111111
36	0.8502251610824503	0.7920855135774713	0.7777777777777778	0.7777777777777778	0.1111111111111111	0.	0.	0.1111111111111111
37	0.6038675202849171	0.274147024612664	0.5555555555555556	0.2222222222222222	0.1111111111111111	0.	0.	0.1111111111111111
38	0.08887112059785769	0.6172553770123397	0.	0.5555555555555556	0.1111111111111111	0.	0.	0.1111111111111111
39	0.4389135435391665	0.38560997135767566	0.3333333333333333	0.3333333333333333	0.1111111111111111	0.	0.	0.1111111111111111
40	0.16439088830258883	0.9416030033455459	0.1111111111111111	0.8888888888888888	0.1111111111111111	0.	0.	0.1111111111111111
41	0.9700758452486836	0.10140166592996071	0.8888888888888888	0.	0.1111111111111111	0.	0.	0.1111111111111111
42	0.2529931958933299	0.13168486983832872	0.2222222222222222	0.1111111111111111	0.1111111111111111	0.	0.	0.1111111111111111
43	0.7618345132661961	0.45999699652780457	0.6666666666666666	0.4444444444444444	0.1111111111111111	0.	0.	0.1111111111111111
44	0.4468856774032585	0.6999063189281488	0.4444444444444444	0.6666666666666666	0.1111111111111111	0.	0.	0.1111111111111111
45	0.9044792190465006	0.5766466402176612	0.8888888888888888	0.5555555555555556	0.1111111111111111	0.	0.	0.1111111111111111
46	0.3684781300591807	0.8843198567470016	0.3333333333333333	0.7777777777777778	0.1111111111111111	0.	0.	0.1111111111111111
47	0.20713081508362524	0.22244391072116654	0.1111111111111111	0.2222222222222222	0.1111111111111111	0.	0.	0.1111111111111111
48	0.5183495247029472	0.07005448886657448	0.4444444444444444	0.	0.1111111111111111	0.	0.	0.1111111111111111
49	0.27764224674240195	0.3518825751452019	0.2222222222222222	0.3333333333333333	0.1111111111111111	0.	0.	0.1111111111111111
50	0.6675295447956204	0.8920198298202723	0.6666666666666666	0.8888888888888888	0.1111111111111111	0.	0.	0.1111111111111111
51	0.03291773846615875	0.7678606426689703	0.	0.6666666666666666	0.1111111111111111	0.	0.	0.1111111111111111
52	0.8587833713323992	0.18998224433091354	0.7777777777777778	0.1111111111111111	0.1111111111111111	0.	0.	0.1111111111111111
53	0.6628644697209083	0.5203158800067146	0.5555555555555556	0.4444444444444444	0.1111111111111111	0.	0.	0.1111111111111111
54	0.10874884145152511	0.33300049600629156	0.	0.2222222222222222	0.1111111111111111	0.	0.	0.1111111111111111
55	0.818184471394852	0.6617766774849123	0.7777777777777778	0.5555555555555556	0.1111111111111111	0.	0.	0.1111111111111111
56	0.6141070923071393	0.8463411907985074	0.5555555555555556	0.7777777777777778	0.1111111111111111	0.	0.	0.1111111111111111
57	0.9851700323125313	0.9993966306034304	0.8888888888888888	0.8888888888888888	0.1111111111111111	0.	0.	0.1111111111111111
58	0.4082890876739357	0.01711964352682098	0.3333333333333333	0.	0.1111111111111111	0.	0.	0.1111111111111111
59	0.17387746022556563	0.41479595571931677	0.1111111111111111	0.3333333333333333	0.1111111111111111	0.	0.	0.1111111111111111
60	0.46691365360390114	0.49582019998259147	0.4444444444444444	0.4444444444444444	0.1111111111111111	0.	0.	0.1111111111111111
61	0.23224331414576613	0.7044077681704646	0.2222222222222222	0.6666666666666666	0.1111111111111111	0.	0.	0.1111111111111111
62	0.7754464469396368	0.1563412013210966	0.6666666666666666	0.1111111111111111	0.1111111111111111	0.	0.	0.1111111111111111
63	0.21153584540198822	0.8145550385006441	0.1111111111111111	0.7777777777777778	0.1111111111111111	0.	0.	0.1111111111111111
64	0.9205672057266957	0.2905121176145815	0.8888888888888888	0.2222222222222222	0.1111111111111111	0.	0.	0.1111111111111111
65	0.339343006026027	0.6213032888923953	0.3333333333333333	0.5555555555555556	0.1111111111111111	0.	0.	0.1111111111111111
66	0.6823963458473669	0.40442566009976827	0.6666666666666666	0.3333333333333333	0.1111111111111111	0.	0.	0.1111111111111111
67	0.4839256268658523	0.9550545660480027	0.4444444444444444	0.8888888888888888	0.1111111111111111	0.	0.	0.1111111111111111
68	0.28727482453825515	0.08132565062487786	0.2222222222222222	0.	0.1111111111111111	0.	0.	0.1111111111111111
69	0.6407554230652303	0.14610241225522794	0.5555555555555556	0.1111111111111111	0.1111111111111111	0.	0.	0.1111111111111111
70	0.009192538256970365	0.47797989675588204	0.	0.4444444444444444	0.1111111111111111	0.	0.	0.1111111111111111
71	0.8692127500429299	0.6730537742244534	0.7777777777777778	0.6666666666666666	0.1111111111111111	0.	0.	0.1111111111111111
72	0.3034554728122979	0.5925147607083149	0.2222222222222222	0.5555555555555556	0.1111111111111111	0.	0.	0.1111111111111111
73	0.7157059548288371	0.8591290775365609	0.6666666666666666	0.7777777777777778	0.1111111111111111	0.	0.	0.1111111111111111
74	0.5481310764301542	0.23871764304133133	0.4444444444444444	0.2222222222222222	0.1111111111111111	0.	0.	0.1111111111111111
75	0.7822525049778667	0.04641116610295401	0.7777777777777778	0.	0.1111111111111111	0.	0.	0.1111111111111111
76	0.5573340237046679	0.3583829954159531	0.5555555555555556	0.3333333333333333	0.1111111111111111	0.	0.	0.1111111111111111
77	0.06655519536379848	0.9014208091267644	0.	0.8888888888888888	0.1111111111111111	0.	0.	0.1111111111111111
78	0.3733986700257697	0.7440416984933047	0.3333333333333333	0.6666666666666666	0.1111111111111111	0.	0.	0.1111111111111111
79	0.11960143818482111	0.20807358917629853	0.1111111111111111	0.1111111111111111	0.1111111111111111	0.	0.	0.1111111111111111
80	0.9461215890073039	0.5423817496308686	0.8888888888888888	0.4444444444444444	0.1111111111111111	0.	0.	0.1111111111111111
81	0.6908623229784836	0.6888139327774859	0.6666666666666666	0.6666666666666666	0.1111111111111111	0.	0.	0.1111111111111111
82	0.4914773931845406	0.11530935749416871	0.4444444444444444	0.1111111111111111	0.1111111111111111	0.	0.	0.1111111111111111
83	0.2937685363357228	0.4563517995387522	0.2222222222222222	0.4444444444444444	0.1111111111111111	0.	0.	0.1111111111111111
84	0.6366665126651747	0.5927260961151696	0.5555555555555556	0.5555555555555556	0.1111111111111111	0.	0.	0.1111111111111111
85	0.007877393564145407	0.7891042351832525	0.	0.7777777777777778	0.1111111111111111	0.	0.	0.1111111111111111
86	0.867651396551031	0.2622768410165318	0.7777777777777778	0.2222222222222222	0.1111111111111111	0.	0.	0.1111111111111111
87	0.22221079278024453	0.09861765812115666	0.1111111111111111	0.	0.1111111111111111	0.	0.	0.1111111111111111
88	0.9156341582474575	0.379035860267404	0.8888888888888888	0.3333333333333333	0.1111111111111111	0.	0.	0.1111111111111111
89	0.3334482377707528	0.9311323482085293	0.3333333333333333	0.8888888888888888	0.1111111111111111	0.	0.	0.1111111111111111
90	0.7804295373753453	0.5483244193279273	0.7777777777777778	0.4444444444444444	0.1111111111111111	0.	0.	0.1111111111111111
91	0.5662582170075505	0.7596857626873386	0.5555555555555556	0.6666666666666666	0.1111111111111111	0.	0.	0.1111111111111111
92	0.06439617256966156	0.21836543170883602	0.	0.1111111111111111	0.1111111111111111	0.	0.	0.1111111111111111
93	0.3813095371250056	0.24807098676704212	0.3333333333333333	0.2222222222222222	0.1111111111111111	0.	0.	0.1111111111111111
94	0.11933690906746722	0.5562613141333713	0.1111111111111111	0.5555555555555556	0.1111111111111111	0.	0.	0.1111111111111111
95	0.9421383992247591	0.8692040213701759	0.8888888888888888	0.7777777777777778	0.1111111111111111	0.	0.	0.1111111111111111
96	0.29956924916276173	0.9140747922601482	0.2222222222222222	0.8888888888888888	0.1111111111111111	0.	0.	0.1111111111111111
97	0.7088917359763077	0.05007188111485418	0.6666666666666666	0.	0.1111111111111111	0.	0.	0.1111111111111111
98	0.5467786406447217	0.3453069291163208	0.4444444444444444	0.3333333333333333	0.1111111111111111	0.	0.	0.1111111111111111
99	0.979923481365833	0.16886996134063523	0.8888888888888888	0.1111111111111111	0.1111111111111111	0.	0.	0.1111111111111111
100	0.41623916970139047	0.512348983346275	0.3333333333333333	0.4444444444444444	0.1111111111111111	0.	0.	0.1111111111111111
101	0.1845045319737852	0.7270169002342052	0.1111111111111111	0.6666666666666666	0.1111111111111111	0.	0.	0.1111111111111111
102	0.4623334750888717	0.8214414011886019	0.4444444444444444	0.7777777777777778	0.1111111111111111	0.	0.	0.1111111111111111
103	0.2271217178707345	0.307970616907667	0.2222222222222222	0.2222222222222222	0.1111111111111111	0.	0.	0.1111111111111111
104	0.770320025588528	0.6416553307277459	0.6666666666666666	0.5555555555555556	0.1111111111111111	0.	0.	0.1111111111111111
105	0.10679159683438082	0.42697015438437497	0.	0.3333333333333333	0.1111111111111111	0.	0.	0.1111111111111111
106	0.8257157268382538	0.9673851649768237	0.7777777777777778	0.8888888888888888	0.1111111111111111	0.	0.	0.1111111111111111
107	0.6094061242761651	0.0256354115196697	0.5555555555555556	0.	0.1111111111111111	0.	0.	0.1111111111111111
108	0.03800785387303905	0.6934638365671638	0.	0.6666666666666666	0.1111111111111111	0.	0.	0.1111111111111111
109	0.8013988000515895	0.13574848558581704	0.7777777777777778	0.1111111111111111	0.1111111111111111	0.	0.	0.1111111111111111
110	0.5749646193854244	0.46201049870992583	0.5555555555555556	0.4444444444444444	0.1111111111111111	0.	0.	0.1111111111111111
111	0.9565721987408881	0.6072769656743684	0.8888888888888888	0.5555555555555556	0.1111111111111111	0.	0.	0.1111111111111111
112	0.38907097485319975	0.7965972754734715	0.3333333333333333	0.7777777777777778	0.1111111111111111	0.	0.	0.1111111111111111
113	0.12371369789204241	0.27818163914058425	0.1111111111111111	0.2222222222222222	0.1111111111111111	0.	0.	0.1111111111111111
114	0.5191939698023216	0.1056330442726447	0.4444444444444444	0.	0.1111111111111111	0.	0.	0.1111111111111111
115	0.314555282421662	0.3877866519685626	0.2222222222222222	0.3333333333333333	0.1111111111111111	0.	0.	0.1111111111111111
116	0.7181141263801357	0.946139291564417	0.6666666666666666	0.8888888888888888	0.1111111111111111	0.	0.	0.1111111111111111
117	0.1558015404807359	0.5264713692861333	0.1111111111111111	0.4444444444444444	0.1111111111111111	0.	0.	0.1111111111111111
118	0.9926731211162145	0.7708524513959474	0.8888888888888888	0.6666666666666666	0.1111111111111111	0.	0.	0.1111111111111111
119	0.42867405755610416	0.19479984790720073	0.3333333333333333	0.1111111111111111	0.1111111111111111	0.	0.	0.1111111111111111
120	0.7490649081288007	0.22754653364069594	0.6666666666666666	0.2222222222222222	0.1111111111111111	0.	0.	0.1111111111111111
121	0.4783558164713724	0.5708019114772906	0.4444444444444444	0.5555555555555556	0.1111111111111111	0.	0.	0.1111111111111111
122	0.24235202920996432	0.8859103439587747	0.2222222222222222	0.7777777777777778	0.1111111111111111	0.	0.	0.1111111111111111
123	0.6211641050644932	0.8942468906611356	0.5555555555555556	0.8888888888888888	0.1111111111111111	0.	0.	0.1111111111111111
124	0.07832842659318759	0.06548039934287866	0.	0.	0.1111111111111111	0.	0.	0.1111111111111111
125	0.8328916749676603	0.357261286543194	0.7777777777777778	0.3333333333333333	0.1111111111111111	0.	0.	0.1111111111111111
126	0.265807534510649	0.1766926296972383	0.2222222222222222	0.1111111111111111	0.1111111111111111	0.	0.	0.1111111111111111
127	0.7035934677510908	0.4821484372586534	0.6666666666666666	0.4444444444444444	0.1111111111111111	0.	0.	0.1111111111111111
128	0.4997373856841458	0.7387865255624104	0.4444444444444444	0.6666666666666666	0.1111111111111111	0.	0.	0.1111111111111111
129	0.8841789968762684	0.8298020078815881	0.7777777777777778	0.7777777777777778	0.1111111111111111	0.	0.	0.1111111111111111
130	0.6481096649829827	0.30915717607628473	0.5555555555555556	0.2222222222222222	0.1111111111111111	0.	0.	0.1111111111111111
131	0.016708769542301282	0.6439302086920172	0.	0.5555555555555556	0.1111111111111111	0.	0.	0.1111111111111111
132	0.3521239958650372	0.4374738038183623	0.3333333333333333	0.3333333333333333	0.1111111111111111	0.	0.	0.1111111111111111
133	0.19406912764836592	0.9795329453178886	0.1111111111111111	0.8888888888888888	0.1111111111111111	0.	0.	0.1111111111111111
134	0.8949345646679691	0.000709076247814727	0.8888888888888888	0.	0.1111111111111111	0.	0.	0.1111111111111111
135	0.43344928168387786	0.6759306983030179	0.3333333333333333	0.6666666666666666	0.1111111111111111	0.	0.	0.1111111111111111
136	0.1702504329862637	0.13990671085372913	0.1111111111111111	0.1111111111111111	0.1111111111111111	0.	0.	0.1111111111111111
137	0.9663982381685549	0.47188283753022336	0.8888888888888888	0.4444444444444444	0.1111111111111111	0.	0.	0.1111111111111111
138	0.24852092683203442	0.6244954415235725	0.2222222222222222	0.5555555555555556	0.1111111111111111	0.	0.	0.1111111111111111
139	0.7604741541345447	0.8026436791438427	0.6666666666666666	0.7777777777777778	0.1111111111111111	0.	0.	0.1111111111111111
140	0.45518368200362963	0.29324763805492327	0.4444444444444444	0.2222222222222222	0.1111111111111111	0.	0.	0.1111111111111111
141	0.8441917510459805	0.08526130291128374	0.7777777777777778	0.	0.1111111111111111	0.	0.	0.1111111111111111
142	0.596935087928885	0.3984210714610227	0.5555555555555556	0.3333333333333333	0.1111111111111111	0.	0.	0.1111111111111111
143	0.09865049496646525	0.9607045253613318	0.	0.8888888888888888	0.1111111111111111	0.	0.	0.1111111111111111
144	0.5111425809662501	0.5346212523106902	0.4444444444444444	0.4444444444444444	0.1111111111111111	0.	0.	0.1111111111111111
145	0.2756393015651787	0.7479801315653528	0.2222222222222222	0.6666666666666666	0.1111111111111111	0.	0.	0.1111111111111111
146	0.6780155570622561	0.19856149459698122	0.6666666666666666	0.1111111111111111	0.1111111111111111	0.	0.	0.1111111111111111
147	0.024992401301040464	0.24314761697248974	0.	0.2222222222222222	0.1111111111111111	0.	0.	0.1111111111111111
148	0.8531406754449342	0.583105747065088	0.7777777777777778	0.5555555555555556	0.1111111111111111	0.	0.	0.1111111111111111
149	0.6614025766372585	0.8623920946008615	0.5555555555555556	0.7777777777777778	0.1111111111111111	0.	0.	0.1111111111111111
150	0.912740936631258	0.9091978655436231	0.8888888888888888	0.8888888888888888	0.1111111111111111	0.	0.	0.1111111111111111
151	0.3633343864440445	0.03917345304195653	0.3333333333333333	0.	0.1111111111111111	0.	0.	0.1111111111111111
152	0.20305215108710134	0.3636060361622572	0.1111111111111111	0.3333333333333333	0.1111111111111111	0.	0.	0.1111111111111111
153	0.5869116264868824	0.1567315455017146	0.5555555555555556	0.1111111111111111	0.1111111111111111	0.	0.	0.1111111111111111
154	0.05072388844841573	0.5010854111022508	0.	0.4444444444444444	0.1111111111111111	0.	0.	0.1111111111111111
155	0.8134721625422346	0.7112962534444929	0.7777777777777778	0.6666666666666666	0.1111111111111111	0.	0.	0.1111111111111111
156	0.1434890923730504	0.8513992652223066	0.1111111111111111	0.7777777777777778	0.1111111111111111	0.	0.	0.1111111111111111
157	0.9330478070473622	0.3215854303117837	0.8888888888888888	0.2222222222222222	0.1111111111111111	0.	0.	0.1111111111111111
158	0.4001306764478668	0.6659847177055214	0.3333333333333333	0.5555555555555556	0.1111111111111111	0.	0.	0.1111111111111111
159	0.7403130030809153	0.41923282827030184	0.6666666666666666	0.3333333333333333	0.1111111111111111	0.	0.	0.1111111111111111
160	0.5390712415315754	0.9912170563252444	0.4444444444444444	0.8888888888888888	0.1111111111111111	0.	0.	0.1111111111111111
161	0.32749969590104294	0.02079470728938827	0.2222222222222222	0.	0.1111111111111111	0.	0.	0.1111111111111111
162	0.035738464346766474	0.3370951839359224	0.	0.3333333333333333	0.1111111111111111	0.	0.	0.1111111111111111
163	0.8636871887279045	0.9201521898170268	0.7777777777777778	0.8888888888888888	0.1111111111111111	0.	0.	0.1111111111111111
164	0.6548067664709046	0.05529040222409784	0.5555555555555556	0.	0.1111111111111111	0.	0.	0.1111111111111111
165	0.9086720208715309	0.21299420485734824	0.8888888888888888	0.1111111111111111	0.1111111111111111	0.	0.	0.1111111111111111
166	0.36004082461765047	0.5534327234131733	0.3333333333333333	0.4444444444444444	0.1111111111111111	0.	0.	0.1111111111111111
167	0.20087433389891432	0.761344076289505	0.1111111111111111	0.6666666666666666	0.1111111111111111	0.	0.	0.1111111111111111
168	0.5101874086306606	0.8729308471516247	0.4444444444444444	0.7777777777777778	0.1111111111111111	0.	0.	0.1111111111111111
169	0.2801012356026082	0.25125033591086093	0.2222222222222222	0.2222222222222222	0.1111111111111111	0.	0.	0.1111111111111111
170	0.6742340318850131	0.5599397428874755	0.6666666666666666	0.5555555555555556	0.1111111111111111	0.	0.	0.1111111111111111
171	0.1373457432190686	0.03225415886561437	0.1111111111111111	0.	0.1111111111111111	0.	0.	0.1111111111111111
172	0.928559462429464	0.43121219383934034	0.8888888888888888	0.3333333333333333	0.1111111111111111	0.	0.	0.1111111111111111
173	0.39798099062334313	0.9744646373964319	0.3333333333333333	0.8888888888888888	0.1111111111111111	0.	0.	0.1111111111111111
174	0.7365416158978624	0.7178236616184748	0.6666666666666666	0.6666666666666666	0.1111111111111111	0.	0.	0.1111111111111111
175	0.5323687075311085	0.1641018543721539	0.4444444444444444	0.1111111111111111	0.1111111111111111	0.	0.	0.1111111111111111
176	0.3211126373855772	0.5163830566878803	0.2222222222222222	0.4444444444444444	0.1111111111111111	0.	0.	0.1111111111111111
177	0.5834519514359844	0.6333120746917096	0.5555555555555556	0.5555555555555556	0.1111111111111111	0.	0.	0.1111111111111111
178	0.060685159925378485	0.8246473140625938	0.	0.7777777777777778	0.1111111111111111	0.	0.	0.1111111111111111
179	0.8082186837223952	0.29795259486134207	0.7777777777777778	0.2222222222222222	0.1111111111111111	0.	0.	0.1111111111111111
180	0.2556792808136691	0.9356674826422686	0.2222222222222222	0.8888888888888888	0.1111111111111111	0.	0.	0.1111111111111111
181	0.756739960819849	0.08894322227409783	0.6666666666666666	0.	0.1111111111111111	0.	0.	0.1111111111111111
182	0.4492416541587024	0.3708213781813348	0.4444444444444444	0.3333333333333333	0.1111111111111111	0.	0.	0.1111111111111111
183	0.8434159144329614	0.4470386567500307	0.7777777777777778	0.4444444444444444	0.1111111111111111	0.	0.	0.1111111111111111
184	0.5965920119418363	0.6826694341403301	0.5555555555555556	0.6666666666666666	0.1111111111111111	0.	0.	0.1111111111111111
185	0.09425218516686833	0.12063530193589392	0.	0.1111111111111111	0.1111111111111111	0.	0.	0.1111111111111111
186	0.44160537329420047	0.26552125727489173	0.3333333333333333	0.2222222222222222	0.1111111111111111	0.	0.	0.1111111111111111
187	0.1665594691869794	0.6007258511307078	0.1111111111111111	0.5555555555555556	0.1111111111111111	0.	0.	0.1111111111111111
188	0.9746930085569119	0.7789808951826845	0.8888888888888888	0.7777777777777778	0.1111111111111111	0.	0.	0.1111111111111111
189	0.37706278272408733	0.34595412686085386	0.3333333333333333	0.3333333333333333	0.1111111111111111	0.	0.	0.1111111111111111