0	0.00023429237545220973	0.19352279102960232	0.	0.1111111111111111	0.1111111111111111	0.	0.	0.1111111111111111
1	0.9661860544155852	0.46070870729469005	0.8888888888888888	0.4444444444444444	0.1111111111111111	0.	0.	0.1111111111111111
2	0.36807479224466116	0.7504692048781482	0.3333333333333333	0.6666666666666666	0.1111111111111111	0.	0.	0.1111111111111111
3	0.6968968506636383	0.8675751908068722	0.6666666666666666	0.7777777777777778	0.1111111111111111	0.	0.	0.1111111111111111
4	0.4508457527655436	0.3311048683333834	0.4444444444444444	0.2222222222222222	0.1111111111111111	0.	0.	0.1111111111111111
5	0.1610740916011113	0.612883799579669	0.1111111111111111	0.5555555555555556	0.1111111111111111	0.	0.	0.1111111111111111
6	0.5925222366509033	0.40062440786398373	0.5555555555555556	0.3333333333333333	0.1111111111111111	0.	0.	0.1111111111111111
7	0.24557399440998592	0.9155305344042695	0.2222222222222222	0.8888888888888888	0.1111111111111111	0.	0.	0.1111111111111111
8	0.8555311909002659	0.04817213388697847	0.7777777777777778	0.	0.1111111111111111	0.	0.	0.1111111111111111
9	0.27347455286496225	0.41836034558994817	0.2222222222222222	0.3333333333333333	0.1111111111111111	0.	0.	0.1111111111111111
10	0.7919617660352152	0.9455997047177338	0.7777777777777778	0.8888888888888888	0.1111111111111111	0.	0.	0.1111111111111111
11	0.6247008264621406	0.09165017169067001	0.5555555555555556	0.	0.1111111111111111	0.	0.	0.1111111111111111
12	0.9078550695856461	0.11308391591029152	0.8888888888888888	0.1111111111111111	0.1111111111111111	0.	0.	0.1111111111111111
13	0.4061610862988371	0.4863580700641089	0.3333333333333333	0.4444444444444444	0.1111111111111111	0.	0.	0.1111111111111111
14	0.04066485669700002	0.6956645960972911	0.	0.6666666666666666	0.1111111111111111	0.	0.	0.1111111111111111
15	0.4925052608665723	0.8074231794178548	0.4444444444444444	0.7777777777777778	0.1111111111111111	0.	0.	0.1111111111111111
16	0.2182706638763582	0.23262028698057152	0.1111111111111111	0.2222222222222222	0.1111111111111111	0.	0.	0.1111111111111111
17	0.7320531430816162	0.6649783873459517	0.6666666666666666	0.5555555555555556	0.1111111111111111	0.	0.	0.1111111111111111
18	0.1331663024151518	0.8469224722219928	0.1111111111111111	0.7777777777777778	0.1111111111111111	0.	0.	0.1111111111111111
19	0.7530456062172799	0.2851008920181297	0.6666666666666666	0.2222222222222222	0.1111111111111111	0.	0.	0.1111111111111111
20	0.5200796749807417	0.5908433450629057	0.4444444444444444	0.5555555555555556	0.1111111111111111	0.	0.	0.1111111111111111
21	0.8510951813220528	0.34550894218021944	0.7777777777777778	0.3333333333333333	0.1111111111111111	0.	0.	0.1111111111111111
22	0.6366027275341135	0.9854465681946247	0.5555555555555556	0.8888888888888888	0.1111111111111111	0.	0.	0.1111111111111111
23	0.3138381864637693	0.01518661893313891	0.2222222222222222	0.	0.1111111111111111	0.	0.	0.1111111111111111
24	0.4408856170054892	0.164551173234413	0.3333333333333333	0.1111111111111111	0.1111111111111111	0.	0.	0.1111111111111111
25	0.08000648876368541	0.5243835559421501	0.	0.4444444444444444	0.1111111111111111	0.	0.	0.1111111111111111
26	0.9327099226632108	0.7159996942409174	0.8888888888888888	0.6666666666666666	0.1111111111111111	0.	0.	0.1111111111111111
27	0.49544568614697093	0.057216442158793526	0.4444444444444444	0.	0.1111111111111111	0.	0.	0.1111111111111111
28	0.19104499228829722	0.377357561489217	0.1111111111111111	0.3333333333333333	0.1111111111111111	0.	0.	0.1111111111111111
29	0.7057250449136674	0.895812483302434	0.6666666666666666	0.8888888888888888	0.1111111111111111	0.	0.	0.1111111111111111
30	0.2935034522657887	0.7624683663370561	0.2222222222222222	0.6666666666666666	0.1111111111111111	0.	0.	0.1111111111111111
31	0.8080321284539325	0.20623184352716742	0.7777777777777778	0.1111111111111111	0.1111111111111111	0.	0.	0.1111111111111111
32	0.5935268479480615	0.47634576790112243	0.5555555555555556	0.4444444444444444	0.1111111111111111	0.	0.	0.1111111111111111
33	0.9197335094995455	0.6235713542759997	0.8888888888888888	0.5555555555555556	0.1111111111111111	0.	0.	0.1111111111111111
34	0.3706667399995633	0.8837122499218155	0.3333333333333333	0.7777777777777778	0.1111111111111111	0.	0.	0.1111111111111111
35	0.056516677929235704	0.30339503804611634	0.	0.2222222222222222	0.1111111111111111	0.	0.	0.1111111111111111
36	0.4163230097001916	0.636384515017222	0.3333333333333333	0.5555555555555556	0.1111111111111111	0.	0.	0.1111111111111111
37	0.09450036684387474	0.7864798807788403	0.	0.7777777777777778	0.1111111111111111	0.	0.	0.1111111111111111
38	0.9392631709780327	0.23851666158695772	0.8888888888888888	0.2222222222222222	0.1111111111111111	0.	0.	0.1111111111111111
39	0.1376742114775797	0.1003564914709506	0.1111111111111111	0.	0.1111111111111111	0.	0.	0.1111111111111111
40	0.7563017255221455	0.42381573508708603	0.6666666666666666	0.3333333333333333	0.1111111111111111	0.	0.	0.1111111111111111
41	0.5417456887951704	0.9575483611898837	0.4444444444444444	0.8888888888888888	0.1111111111111111	0.	0.	0.1111111111111111
42	0.8232129199547833	0.6768416275818943	0.7777777777777778	0.6666666666666666	0.1111111111111111	0.	0.	0.1111111111111111
43	0.6526104121457552	0.1287718187769878	0.5555555555555556	0.1111111111111111	0.1111111111111111	0.	0.	0.1111111111111111
44	0.32922022269882245	0.5011490035055941	0.2222222222222222	0.4444444444444444	0.1111111111111111	0.	0.	0.1111111111111111
45	0.5619935535555357	0.7181466922020913	0.5555555555555556	0.6666666666666666	0.1111111111111111	0.	0.	0.1111111111111111
46	0.2538071865717286	0.18340039832018282	0.2222222222222222	0.1111111111111111	0.1111111111111111	0.	0.	0.1111111111111111
47	0.8679227115769125	0.5378510333079812	0.7777777777777778	0.4444444444444444	0.1111111111111111	0.	0.	0.1111111111111111
48	0.019256757309325825	0.5587112946935546	0.	0.5555555555555556	0.1111111111111111	0.	0.	0.1111111111111111
49	0.9799073412798603	0.8185230200013163	0.8888888888888888	0.7777777777777778	0.1111111111111111	0.	0.	0.1111111111111111
50	0.3379603618916155	0.2615982914625872	0.3333333333333333	0.2222222222222222	0.1111111111111111	0.	0.	0.1111111111111111
51	0.6699202452351456	0.03218498596237124	0.6666666666666666	0.	0.1111111111111111	0.	0.	0.1111111111111111
52	0.4594175744105607	0.3459866737541942	0.4444444444444444	0.3333333333333333	0.1111111111111111	0.	0.	0.1111111111111111
53	0.1808276269731998	0.9967798485054654	0.1111111111111111	0.8888888888888888	0.1111111111111111	0.	0.	0.1111111111111111
54	0.8351004395812084	0.3119513941521732	0.7777777777777778	0.2222222222222222	0.1111111111111111	0.	0.	0.1111111111111111
55	0.6595034901901295	0.598988752330374	0.5555555555555556	0.5555555555555556	0.1111111111111111	0.	0.	0.1111111111111111
56	0.2969578625805033	0.8523554872356447	0.2222222222222222	0.7777777777777778	0.1111111111111111	0.	0.	0.1111111111111111
57	0.4239815841713696	0.912866312034416	0.3333333333333333	0.8888888888888888	0.1111111111111111	0.	0.	0.1111111111111111
58	0.10401849707024662	0.06911746477094557	0.	0.	0.1111111111111111	0.	0.	0.1111111111111111
59	0.9615562054936473	0.3860433187707152	0.8888888888888888	0.3333333333333333	0.1111111111111111	0.	0.	0.1111111111111111
60	0.11397758745451042	0.45318745132243127	0.1111111111111111	0.4444444444444444	0.1111111111111111	0.	0.	0.1111111111111111
61	0.7661623268802734	0.7729167777701091	0.6666666666666666	0.6666666666666666	0.1111111111111111	0.	0.	0.1111111111111111
62	0.5453741614923556	0.21421518657298821	0.4444444444444444	0.1111111111111111	0.1111111111111111	0.	0.	0.1111111111111111
63	0.6842028016747457	0.5065489321603743	0.6666666666666666	0.4444444444444444	0.1111111111111111	0.	0.	0.1111111111111111
64	0.47952916002505663	0.6808577015312854	0.4444444444444444	0.6666666666666666	0.1111111111111111	0.	0.	0.1111111111111111
65	0.153799955582628	0.1368876122260707	0.1111111111111111	0.1111111111111111	0.1111111111111111	0.	0.	0.1111111111111111
66	0.5788390892253507	0.24878761983425543	0.5555555555555556	0.2222222222222222	0.1111111111111111	0.	0.	0.1111111111111111
67	0.22698690913410452	0.6440515135825285	0.2222222222222222	0.5555555555555556	0.1111111111111111	0.	0.	0.1111111111111111
68	0.8779553009133703	0.7982582511272398	0.7777777777777778	0.7777777777777778	0.1111111111111111	0.	0.	0.1111111111111111
69	0.034787108708302386	0.9350656912038883	0.	0.8888888888888888	0.1111111111111111	0.	0.	0.1111111111111111
70	0.9955797674225055	0.07814332538652423	0.8888888888888888	0.	0.1111111111111111	0.	0.	0.1111111111111111
71	0.34583427603214173	0.4341886110210346	0.3333333333333333	0.3333333333333333	0.1111111111111111	0.	0.	0.1111111111111111
72	0.8957952961198877	0.9725875855781081	0.8888888888888888	0.8888888888888888	0.1111111111111111	0.	0.	0.1111111111111111
73	0.38756280732827564	0.01015007580906061	0.3333333333333333	0.	0.1111111111111111	0.	0.	0.1111111111111111
74	0.07009671430499209	0.3702389662032908	0.	0.3333333333333333	0.1111111111111111	0.	0.	0.1111111111111111
75	0.5087739960323403	0.554271684376507	0.4444444444444444	0.4444444444444444	0.1111111111111111	0.	0.	0.1111111111111111
76	0.20705799412000983	0.7359202918494415	0.1111111111111111	0.6666666666666666	0.1111111111111111	0.	0.	0.1111111111111111
77	0.728162225995917	0.1518223876555653	0.6666666666666666	0.1111111111111111	0.1111111111111111	0.	0.	0.1111111111111111
78	0.26739732652601145	0.2720226497881479	0.2222222222222222	0.2222222222222222	0.1111111111111111	0.	0.	0.1111111111111111
79	0.781360330515027	0.5744196611139996	0.7777777777777778	0.5555555555555556	0.1111111111111111	0.	0.	0.1111111111111111
80	0.6149057989892046	0.8379217488073191	0.5555555555555556	0.7777777777777778	0.1111111111111111	0.	0.	0.1111111111111111
81	0.32273897367364074	0.7086331074245276	0.2222222222222222	0.6666666666666666	0.1111111111111111	0.	0.	0.1111111111111111
82	0.8174940475764736	0.17228222623335063	0.7777777777777778	0.1111111111111111	0.1111111111111111	0.	0.	0.1111111111111111
83	0.6443075704238246	0.5196190608975941	0.5555555555555556	0.4444444444444444	0.1111111111111111	0.	0.	0.1111111111111111
84	0.94647265200955	0.5858208555751768	0.8888888888888888	0.5555555555555556	0.1111111111111111	0.	0.	0.1111111111111111
85	0.40864969069821194	0.840425428127869	0.3333333333333333	0.7777777777777778	0.1111111111111111	0.	0.	0.1111111111111111
86	0.09596010980892307	0.29438341002833923	0.	0.2222222222222222	0.1111111111111111	0.	0.	0.1111111111111111
87	0.5333805400949424	0.02456175035526666	0.4444444444444444	0.	0.1111111111111111	0.	0.	0.1111111111111111
88	0.1406079945348477	0.3404362626090572	0.1111111111111111	0.3333333333333333	0.1111111111111111	0.	0.	0.1111111111111111
89	0.758575304295105	0.9818279624682766	0.6666666666666666	0.8888888888888888	0.1111111111111111	0.	0.	0.1111111111111111
90	0.18363028549065724	0.04471672293683638	0.1111111111111111	0.	0.1111111111111111	0.	0.	0.1111111111111111
91	0.6733555410901357	0.39886628969692933	0.6666666666666666	0.3333333333333333	0.1111111111111111	0.	0.	0.1111111111111111
92	0.4643274687519174	0.9219915986425798	0.4444444444444444	0.8888888888888888	0.1111111111111111	0.	0.	0.1111111111111111
93	0.8690300605139137	0.7470898912628239	0.7777777777777778	0.6666666666666666	0.1111111111111111	0.	0.	0.1111111111111111
94	0.5657925739355171	0.19331630565018124	0.5555555555555556	0.1111111111111111	0.1111111111111111	0.	0.	0.1111111111111111
95	0.2564247008629428	0.4684968145812238	0.2222222222222222	0.4444444444444444	0.1111111111111111	0.	0.	0.1111111111111111
96	0.3445218820112532	0.6061108416665766	0.3333333333333333	0.5555555555555556	0.1111111111111111	0.	0.	0.1111111111111111
97	0.02062455366594374	0.8727210320567222	0.	0.7777777777777778	0.1111111111111111	0.	0.	0.1111111111111111
98	0.9871610782739648	0.32554191267875876	0.8888888888888888	0.2222222222222222	0.1111111111111111	0.	0.	0.1111111111111111
99	0.05922552106771341	0.6590114967650391	0.	0.5555555555555556	0.1111111111111111	0.	0.	0.1111111111111111
100	0.9240167599912352	0.8046332039329324	0.8888888888888888	0.7777777777777778	0.1111111111111111	0.	0.	0.1111111111111111
101	0.37732736948767837	0.22848492747974763	0.3333333333333333	0.2222222222222222	0.1111111111111111	0.	0.	0.1111111111111111
102	0.7107425277826922	0.08881065141601224	0.6666666666666666	0.	0.1111111111111111	0.	0.	0.1111111111111111
103	0.49946018299856454	0.4146843018413516	0.4444444444444444	0.3333333333333333	0.1111111111111111	0.	0.	0.1111111111111111
104	0.19736295103380563	0.9413750374295081	0.1111111111111111	0.8888888888888888	0.1111111111111111	0.	0.	0.1111111111111111
105	0.5978034166386074	0.6922823287576134	0.5555555555555556	0.6666666666666666	0.1111111111111111	0.	0.	0.1111111111111111
106	0.2876874760918147	0.1233053990595732	0.2222222222222222	0.1111111111111111	0.1111111111111111	0.	0.	0.1111111111111111
107	0.8117703613071775	0.48151078986084983	0.7777777777777778	0.4444444444444444	0.1111111111111111	0.	0.	0.1111111111111111
108	0.3538426160350371	0.9923962006390772	0.3333333333333333	0.8888888888888888	0.1111111111111111	0.	0.	0.1111111111111111
109	0.025364702209472803	0.027901966055629373	0.	0.	0.1111111111111111	0.	0.	0.1111111111111111
110	0.9984935954174587	0.35788057404470425	0.8888888888888888	0.3333333333333333	0.1111111111111111	0.	0.	0.1111111111111111
111	0.15926222821254382	0.5334590344807499	0.1111111111111111	0.4444444444444444	0.1111111111111111	0.	0.	0.1111111111111111
112	0.6901531305778031	0.7278684401226907	0.6666666666666666	0.6666666666666666	0.1111111111111111	0.	0.	0.1111111111111111
113	0.47113593330544457	0.17878179987877033	0.4444444444444444	0.1111111111111111	0.1111111111111111	0.	0.	0.1111111111111111
114	0.8808141387001691	0.2710767369869279	0.7777777777777778	0.2222222222222222	0.1111111111111111	0.	0.	0.1111111111111111
115	0.569959814386585	0.5647285706667932	0.5555555555555556	0.5555555555555556	0.1111111111111111	0.	0.	0.1111111111111111
116	0.23113463848492194	0.8237408433329745	0.2222222222222222	0.7777777777777778	0.1111111111111111	0.	0.	0.1111111111111111
117	0.6058005810150464	0.29832992647944345	0.5555555555555556	0.2222222222222222	0.1111111111111111	0.	0.	0.1111111111111111
118	0.2703472513900351	0.620017438812673	0.2222222222222222	0.5555555555555556	0.1111111111111111	0.	0.	0.1111111111111111
119	0.7820844292001293	0.8784672494007754	0.7777777777777778	0.7777777777777778	0.1111111111111111	0.	0.	0.1111111111111111
120	0.0654916988657252	0.8892878576348777	0.	0.8888888888888888	0.1111111111111111	0.	0.	0.1111111111111111
121	0.8991025020362309	0.05193266895081536	0.8888888888888888	0.	0.1111111111111111	0.	0.	0.1111111111111111
122	0.39272098573323866	0.3707232771918094	0.3333333333333333	0.3333333333333333	0.1111111111111111	0.	0.	0.1111111111111111
123	0.716091125474781	0.4732321165388856	0.6666666666666666	0.4444444444444444	0.1111111111111111	0.	0.	0.1111111111111111
124	0.5128228164859224	0.7578365471183602	0.4444444444444444	0.6666666666666666	0.1111111111111111	0.	0.	0.1111111111111111
125	0.20143351444344154	0.20323606065140254	0.1111111111111111	0.1111111111111111	0.1111111111111111	0.	0.	0.1111111111111111
126	0.5508957908177817	0.49647808034919577	0.4444444444444444	0.4444444444444444	0.1111111111111111	0.	0.	0.1111111111111111
127	0.11677925566123931	0.672738790883446	0.1111111111111111	0.6666666666666666	0.1111111111111111	0.	0.	0.1111111111111111
128	0.7706130448528413	0.12366438368725512	0.6666666666666666	0.1111111111111111	0.1111111111111111	0.	0.	0.1111111111111111
129	0.30449993916902357	0.24458516011354614	0.2222222222222222	0.2222222222222222	0.1111111111111111	0.	0.	0.1111111111111111
130	0.835565988010166	0.6337179670088814	0.7777777777777778	0.5555555555555556	0.1111111111111111	0.	0.	0.1111111111111111
131	0.6644774028286702	0.784231194855572	0.5555555555555556	0.7777777777777778	0.1111111111111111	0.	0.	0.1111111111111111
132	0.9508419829597604	0.9541394802173203	0.8888888888888888	0.8888888888888888	0.1111111111111111	0.	0.	0.1111111111111111
133	0.42997931290791047	0.10933924216554972	0.3333333333333333	0.	0.1111111111111111	0.	0.	0.1111111111111111
134	0.10873763054901311	0.42919097050302535	0.	0.3333333333333333	0.1111111111111111	0.	0.	0.1111111111111111
135	0.7330909173124984	0.8322903705109239	0.6666666666666666	0.7777777777777778	0.1111111111111111	0.	0.	0.1111111111111111
136	0.4842345410045328	0.28232484197120866	0.4444444444444444	0.2222222222222222	0.1111111111111111	0.	0.	0.1111111111111111
137	0.21195601075536652	0.5689187715280248	0.1111111111111111	0.5555555555555556	0.1111111111111111	0.	0.	0.1111111111111111
138	0.6281272998616928	0.3653640906603333	0.5555555555555556	0.3333333333333333	0.1111111111111111	0.	0.	0.1111111111111111
139	0.2791871856834087	0.9697196706599583	0.2222222222222222	0.8888888888888888	0.1111111111111111	0.	0.	0.1111111111111111
140	0.798305578687829	0.005059496651109403	0.7777777777777778	0.	0.1111111111111111	0.	0.	0.1111111111111111
141	0.04394410246760767	0.15929910631718472	0.	0.1111111111111111	0.1111111111111111	0.	0.	0.1111111111111111
142	0.9105624035972621	0.5477353909385004	0.8888888888888888	0.4444444444444444	0.1111111111111111	0.	0.	0.1111111111111111
143	0.3960177318689341	0.729407588628248	0.3333333333333333	0.6666666666666666	0.1111111111111111	0.	0.	0.1111111111111111
144	0.9369240544563284	0.2100476966083571	0.8888888888888888	0.1111111111111111	0.1111111111111111	0.	0.	0.1111111111111111
145	0.43283832793537846	0.45238094346975377	0.3333333333333333	0.4444444444444444	0.1111111111111111	0.	0.	0.1111111111111111
146	0.08443410866343383	0.7681866699965199	0.	0.6666666666666666	0.1111111111111111	0.	0.	0.1111111111111111
147	0.5244331644008637	0.8612892609989625	0.4444444444444444	0.7777777777777778	0.1111111111111111	0.	0.	0.1111111111111111
148	0.1267733992595661	0.32057699887593377	0.1111111111111111	0.2222222222222222	0.1111111111111111	0.	0.	0.1111111111111111
149	0.7428454427113862	0.5941466430806143	0.6666666666666666	0.5555555555555556	0.1111111111111111	0.	0.	0.1111111111111111
150	0.3176777872134343	0.3937964760901774	0.2222222222222222	0.3333333333333333	0.1111111111111111	0.	0.	0.1111111111111111
151	0.8413979485392336	0.9082072726067586	0.7777777777777778	0.8888888888888888	0.1111111111111111	0.	0.	0.1111111111111111
152	0.6395290002331291	0.06488871492459107	0.5555555555555556	0.	0.1111111111111111	0.	0.	0.1111111111111111
153	0.8584078155625546	0.44347437700952363	0.7777777777777778	0.3333333333333333	0.1111111111111111	0.	0.	0.1111111111111111
154	0.5806174481047303	0.9326566196829787	0.5555555555555556	0.8888888888888888	0.1111111111111111	0.	0.	0.1111111111111111
155	0.2378652797580874	0.08623437053170413	0.2222222222222222	0.	0.1111111111111111	0.	0.	0.1111111111111111
156	0.35967942142918863	0.1449519688842958	0.3333333333333333	0.1111111111111111	0.1111111111111111	0.	0.	0.1111111111111111
157	0.007580370037338596	0.5159574631239151	0.	0.4444444444444444	0.1111111111111111	0.	0.	0.1111111111111111
158	0.9692442062178425	0.6910349502277701	0.8888888888888888	0.6666666666666666	0.1111111111111111	0.	0.	0.1111111111111111
159	0.16589101460764513	0.7938917190308953	0.1111111111111111	0.7777777777777778	0.1111111111111111	0.	0.	0.1111111111111111
160	0.7033435816383303	0.25920387327097033	0.6666666666666666	0.2222222222222222	0.1111111111111111	0.	0.	0.1111111111111111
161	0.4544372991761586	0.6507895413175562	0.4444444444444444	0.5555555555555556	0.1111111111111111	0.	0.	0.1111111111111111
162	0.20454791606715123	0.4902859013908959	0.1111111111111111	0.4444444444444444	0.1111111111111111	0.	0.	0.1111111111111111
163	0.7221912330678687	0.6998419211982703	0.6666666666666666	0.6666666666666666	0.1111111111111111	0.	0.	0.1111111111111111
164	0.5157723722419509	0.11527104253556052	0.4444444444444444	0.1111111111111111	0.1111111111111111	0.	0.	0.1111111111111111
165	0.7894771022293557	0.22352258624779822	0.7777777777777778	0.2222222222222222	0.1111111111111111	0.	0.	0.1111111111111111
166	0.6110239590348564	0.6572873003970973	0.5555555555555556	0.5555555555555556	0.1111111111111111	0.	0.	0.1111111111111111
167	0.2630536989143769	0.8134174588444824	0.2222222222222222	0.7777777777777778	0.1111111111111111	0.	0.	0.1111111111111111
168	0.3856421844190763	0.9493378523922105	0.3333333333333333	0.8888888888888888	0.1111111111111111	0.	0.	0.1111111111111111
169	0.06904428158246771	0.09500059163537597	0.	0.	0.1111111111111111	0.	0.	0.1111111111111111
170	0.8928585679421823	0.409046357896678	0.8888888888888888	0.3333333333333333	0.1111111111111111	0.	0.	0.1111111111111111
171	0.09898090082685328	0.9781664937533372	0.	0.8888888888888888	0.1111111111111111	0.	0.	0.1111111111111111
172	0.9577501221590443	0.01796933271298067	0.8888888888888888	0.	0.1111111111111111	0.	0.	0.1111111111111111
173	0.42126894068320697	0.33370577190442124	0.3333333333333333	0.3333333333333333	0.1111111111111111	0.	0.	0.1111111111111111
174	0.7773089495360515	0.5307736241074231	0.6666666666666666	0.4444444444444444	0.1111111111111111	0.	0.	0.1111111111111111
175	0.5531643087673663	0.7054862561317281	0.4444444444444444	0.6666666666666666	0.1111111111111111	0.	0.	0.1111111111111111
176	0.1232424046283899	0.1683413573926907	0.1111111111111111	0.1111111111111111	0.1111111111111111	0.	0.	0.1111111111111111
177	0.6575999864925403	0.289107666855138	0.5555555555555556	0.2222222222222222	0.1111111111111111	0.	0.	0.1111111111111111
178	0.3057725813773365	0.5837104276984518	0.2222222222222222	0.5555555555555556	0.1111111111111111	0.	0.	0.1111111111111111
179	0.8297395288249715	0.8509534748259878	0.7777777777777778	0.7777777777777778	0.1111111111111111	0.	0.	0.1111111111111111
180	0.22462700985336892	0.32491022693433236	0.2222222222222222	0.2222222222222222	0.1111111111111111	0.	0.	0.1111111111111111
181	0.8865858468660737	0.6145966491032263	0.7777777777777778	0.5555555555555556	0.1111111111111111	0.	0.	0.1111111111111111
182	0.5737227903813834	0.8685506597802403	0.5555555555555556	0.7777777777777778	0.1111111111111111	0.	0.	0.1111111111111111
183	0.9883016701611085	0.9192320543480601	0.8888888888888888	0.8888888888888888	0.1111111111111111	0.	0.	0.1111111111111111
184	0.357252004638643	0.0375755036538607	0.3333333333333333	0.	0.1111111111111111	0.	0.	0.1111111111111111
185	0.02915018776923799	0.4065981987855062	0.	0.3333333333333333	0.1111111111111111	0.	0.	0.1111111111111111
186	0.47549972935650975	0.46283357168202505	0.4444444444444444	0.4444444444444444	0.1111111111111111	0.	0.	0.1111111111111111
187	0.1481772870303718	0.744758857259784	0.1111111111111111	0.6666666666666666	0.1111111111111111	0.	0.	0.1111111111111111
188	0.6793297295125763	0.18527327207691044	0.6666666666666666	0.1111111111111111	0.1111111111111111	0.	0.	0.1111111111111111
189	0.633171454870232	0.4246731918885856	0.5555555555555556	0.3333333333333333	0.1111111111111111	0.	0.	0.1111111111111111